A	A SP
AI	AI SP
AM	A M SP
AN	A N SP
ANG	A NG SP
ANH	A NH SP
AO	AO SP
AU	AU SP
B	B  SP
BA	B A SP
BAN	B A N SP
BANG	B A NG SP
BANH	B A NH SP
BAO	B AO SP
BAY	B AY SP
BE	B E SP
BEN	B E N SP
BENG	B E NG SP
BI	B I SP
BIA	B IA SP
BINH	B I NH SP
BIÊN	B IÊ N SP
BIÊNG	B IÊ NG SP
BIẾC	B IẾ C SP
BIẾM	B IẾ M SP
BIẾN	B IẾ N SP
BIẾNG	B IẾ NG SP
BIẾT	B IẾ T SP
BIẾU	B IẾU SP
BIỀN	B IỀ N SP
BIỂN	B IỂ N SP
BIỂU	B IỂU SP
BIỆN	B IỆ N SP
BIỆT	B IỆ T SP
BO	B O SP
BOA	B OA SP
BOM	B O M SP
BON	B O N SP
BONG	B O NG SP
BU	B U SP
BUNG	B U NG SP
BUÔN	B UÔ N SP
BUÔNG	B UÔ NG SP
BUÝT	B UÝ T SP
BUỐT	B UỐ T SP
BUỒN	B UỒ N SP
BUỒNG	B UỒ NG SP
BUỔI	B UỔI SP
BUỘC	B UỘ C SP
BÀ	B À SP
BÀI	B ÀI SP
BÀN	B À N SP
BÀNG	B À NG SP
BÀNH	B À NH SP
BÀO	B ÀO SP
BÀU	B ÀU SP
BÀY	B ÀY SP
BÁ	B Á SP
BÁC	B Á C SP
BÁCH	B Á CH SP
BÁI	B ÁI SP
BÁM	B Á M SP
BÁN	B Á N SP
BÁNG	B Á NG SP
BÁNH	B Á NH SP
BÁO	B ÁO SP
BÁT	B Á T SP
BÁU	B ÁU SP
BÂNG	B Â NG SP
BÂU	B ÂU SP
BÂY	B ÂY SP
BÃ	B Ã SP
BÃI	B ÃI SP
BÃO	B ÃO SP
BÈ	B È SP
BÈN	B È N SP
BÈO	B ÈO SP
BÉ	B É SP
BÉN	B É N SP
BÉNG	B É NG SP
BÉO	B ÉO SP
BÉT	B É T SP
BÊ	B Ê SP
BÊN	B Ê N SP
BÊNH	B Ê NH SP
BÊU	B ÊU SP
BÌ	B Ì SP
BÌA	B ÌA SP
BÌNH	B Ì NH SP
BÌU	B ÌU SP
BÍ	B Í SP
BÍCH	B Í CH SP
BÍNH	B Í NH SP
BÍU	B ÍU SP
BÒ	B Ò SP
BÓ	B Ó SP
BÓC	B Ó C SP
BÓI	B ÓI SP
BÓN	B Ó N SP
BÓNG	B Ó NG SP
BÓP	B Ó P SP
BÓT	B Ó T SP
BÔI	B ÔI SP
BÔNG	B Ô NG SP
BÕM	B Õ M SP
BÕNG	B Õ NG SP
BÙ	B Ù SP
BÙA	B ÙA SP
BÙI	B ÙI SP
BÙN	B Ù N SP
BÙNG	B Ù NG SP
BÚ	B Ú SP
BÚA	B ÚA SP
BÚN	B Ú N SP
BÚNG	B Ú NG SP
BÚP	B Ú P SP
BÚT	B Ú T SP
BĂN	B Ă N SP
BĂNG	B Ă NG SP
BĨNH	B Ĩ NH SP
BĨU	B ĨU SP
BŨM	B Ũ M SP
BƠ	B Ơ SP
BƠI	B ƠI SP
BƠM	B Ơ M SP
BƯNG	B Ư NG SP
BƯU	B ƯU SP
BƯƠI	B ƯƠI SP
BƯƠM	B ƯƠ M SP
BƯƠU	B ƯƠU SP
BƯỚC	B ƯỚ C SP
BƯỚNG	B ƯỚ NG SP
BƯỞI	B ƯỞI SP
BẠ	B Ạ SP
BẠC	B Ạ C SP
BẠCH	B Ạ CH SP
BẠI	B ẠI SP
BẠN	B Ạ N SP
BẠO	B ẠO SP
BẠT	B Ạ T SP
BẢ	B Ả SP
BẢN	B Ả N SP
BẢNG	B Ả NG SP
BẢNH	B Ả NH SP
BẢO	B ẢO SP
BẢY	B ẢY SP
BẤC	B Ấ C SP
BẤM	B Ấ M SP
BẤP	B Ấ P SP
BẤT	B Ấ T SP
BẤU	B ẤU SP
BẤY	B ẤY SP
BẦM	B Ầ M SP
BẦN	B Ầ N SP
BẦU	B ẦU SP
BẦY	B ẦY SP
BẨM	B Ẩ M SP
BẨN	B Ẩ N SP
BẪY	B ẪY SP
BẬC	B Ậ C SP
BẬN	B Ậ N SP
BẬP	B Ậ P SP
BẬT	B Ậ T SP
BẬY	B ẬY SP
BẮC	B Ắ C SP
BẮN	B Ắ N SP
BẮNG	B Ắ NG SP
BẮP	B Ắ P SP
BẮT	B Ắ T SP
BẰM	B Ằ M SP
BẰNG	B Ằ NG SP
BẴNG	B Ẵ NG SP
BẶM	B Ặ M SP
BẶT	B Ặ T SP
BẸ	B Ẹ SP
BẸO	B ẸO SP
BẸP	B Ẹ P SP
BẸT	B Ẹ T SP
BẼN	B Ẽ N SP
BẾ	B Ế SP
BẾN	B Ế N SP
BẾP	B Ế P SP
BẾT	B Ế T SP
BỀ	B Ề SP
BỀN	B Ề N SP
BỀNH	B Ề NH SP
BỀU	B ỀU SP
BỂ	B Ể SP
BỆ	B Ệ SP
BỆCH	B Ệ CH SP
BỆN	B Ệ N SP
BỆNH	B Ệ NH SP
BỆT	B Ệ T SP
BỆU	B ỆU SP
BỈ	B Ỉ SP
BỈNH	B Ỉ NH SP
BỈU	B ỈU SP
BỊ	B Ị SP
BỊA	B ỊA SP
BỊCH	B Ị CH SP
BỊN	B Ị N SP
BỊT	B Ị T SP
BỊU	B ỊU SP
BỌ	B Ọ SP
BỌC	B Ọ C SP
BỌN	B Ọ N SP
BỌNG	B Ọ NG SP
BỌP	B Ọ P SP
BỌT	B Ọ T SP
BỎ	B Ỏ SP
BỐ	B Ố SP
BỐC	B Ố C SP
BỐI	B ỐI SP
BỐN	B Ố N SP
BỐNG	B Ố NG SP
BỒ	B Ồ SP
BỒI	B ỒI SP
BỒN	B Ồ N SP
BỒNG	B Ồ NG SP
BỔ	B Ổ SP
BỔN	B Ổ N SP
BỔNG	B Ổ NG SP
BỖ	B Ỗ SP
BỖNG	B Ỗ NG SP
BỘ	B Ộ SP
BỘC	B Ộ C SP
BỘI	B ỘI SP
BỘNG	B Ộ NG SP
BỘT	B Ộ T SP
BỚI	B ỚI SP
BỚT	B Ớ T SP
BỜ	B Ờ SP
BỜI	B ỜI SP
BỜM	B Ờ M SP
BỞ	B Ở SP
BỞI	B ỞI SP
BỠ	B Ỡ SP
BỢ	B Ợ SP
BỢM	B Ợ M SP
BỢN	B Ợ N SP
BỤA	B ỤA SP
BỤC	B Ụ C SP
BỤI	B ỤI SP
BỤNG	B Ụ NG SP
BỤT	B Ụ T SP
BỦA	B ỦA SP
BỦM	B Ủ M SP
BỨC	B Ứ C SP
BỨT	B Ứ T SP
BỪA	B ỪA SP
BỪNG	B Ừ NG SP
BỬU	B ỬU SP
BỮA	B ỮA SP
BỰ	B Ự SP
BỰC	B Ự C SP
C	C  SP
CA	C A SP
CAI	C AI SP
CAM	C A M SP
CAN	C A N SP
CANH	C A NH SP
CAO	C AO SP
CAY	C AY SP
CHA	CH A SP
CHAI	CH AI SP
CHAN	CH A N SP
CHANG	CH A NG SP
CHANH	CH A NH SP
CHAO	CH AO SP
CHAY	CH AY SP
CHE	CH E SP
CHEM	CH E M SP
CHEN	CH E N SP
CHENG	CH E NG SP
CHEO	CH EO SP
CHI	CH I SP
CHIA	CH IA SP
CHIM	CH I M SP
CHINH	CH I NH SP
CHIÊM	CH IÊ M SP
CHIÊN	CH IÊ N SP
CHIÊNG	CH IÊ NG SP
CHIÊU	CH IÊU SP
CHIẾC	CH IẾ C SP
CHIẾM	CH IẾ M SP
CHIẾN	CH IẾ N SP
CHIẾNG	CH IẾ NG SP
CHIẾT	CH IẾ T SP
CHIẾU	CH IẾU SP
CHIỀN	CH IỀ N SP
CHIỀU	CH IỀU SP
CHIỂU	CH IỂU SP
CHO	CH O SP
CHOANG	CH OA NG SP
CHONG	CH O NG SP
CHOÀNG	CH OÀ NG SP
CHOÁNG	CH OÁ NG SP
CHOÈN	CH OÈ N SP
CHOẠC	CH OẠ C SP
CHOẠNG	CH OẠ NG SP
CHOẢNG	CH OẢ NG SP
CHOẮT	CH OẮ T SP
CHU	CH U SP
CHUA	CH UA SP
CHUI	CH UI SP
CHUM	CH U M SP
CHUNG	CH U NG SP
CHUYÊN	CH UYÊ N SP
CHUYẾN	CH UYẾ N SP
CHUYỀN	CH UYỀ N SP
CHUYỂN	CH UYỂ N SP
CHUYỆN	CH UYỆ N SP
CHUÔI	CH UÔI SP
CHUÔNG	CH UÔ NG SP
CHUẨN	CH UẨ N SP
CHUỐC	CH UỐ C SP
CHUỐI	CH UỐI SP
CHUỐT	CH UỐ T SP
CHUỒI	CH UỒI SP
CHUỒN	CH UỒ N SP
CHUỒNG	CH UỒ NG SP
CHUỖI	CH UỖI SP
CHUỘC	CH UỘ C SP
CHUỘNG	CH UỘ NG SP
CHUỘT	CH UỘ T SP
CHÀ	CH À SP
CHÀI	CH ÀI SP
CHÀM	CH À M SP
CHÀNG	CH À NG SP
CHÀNH	CH À NH SP
CHÀO	CH ÀO SP
CHÀY	CH ÀY SP
CHÁC	CH Á C SP
CHÁI	CH ÁI SP
CHÁN	CH Á N SP
CHÁNH	CH Á NH SP
CHÁO	CH ÁO SP
CHÁT	CH Á T SP
CHÁU	CH ÁU SP
CHÁY	CH ÁY SP
CHÂM	CH Â M SP
CHÂN	CH Â N SP
CHÂU	CH ÂU SP
CHÃ	CH Ã SP
CHÃO	CH ÃO SP
CHÈ	CH È SP
CHÈN	CH È N SP
CHÈO	CH ÈO SP
CHÉ	CH É SP
CHÉM	CH É M SP
CHÉN	CH É N SP
CHÉO	CH ÉO SP
CHÉP	CH É P SP
CHÉT	CH É T SP
CHÊ	CH Ê SP
CHÊM	CH Ê M SP
CHÊNH	CH Ê NH SP
CHÌ	CH Ì SP
CHÌM	CH Ì M SP
CHÌU	CH ÌU SP
CHÍ	CH Í SP
CHÍCH	CH Í CH SP
CHÍN	CH Í N SP
CHÍNH	CH Í NH SP
CHÍT	CH Í T SP
CHÒ	CH Ò SP
CHÒNG	CH Ò NG SP
CHÓ	CH Ó SP
CHÓE	CH ÓE SP
CHÓI	CH ÓI SP
CHÓNG	CH Ó NG SP
CHÓT	CH Ó T SP
CHÔN	CH Ô N SP
CHÔNG	CH Ô NG SP
CHÙ	CH Ù SP
CHÙA	CH ÙA SP
CHÙI	CH ÙI SP
CHÙM	CH Ù M SP
CHÚ	CH Ú SP
CHÚA	CH ÚA SP
CHÚC	CH Ú C SP
CHÚI	CH ÚI SP
CHÚNG	CH Ú NG SP
CHÚT	CH Ú T SP
CHĂM	CH Ă M SP
CHĂN	CH Ă N SP
CHĂNG	CH Ă NG SP
CHĨN	CH Ĩ N SP
CHŨI	CH ŨI SP
CHŨN	CH Ũ N SP
CHƠ	CH Ơ SP
CHƠI	CH ƠI SP
CHƯ	CH Ư SP
CHƯA	CH ƯA SP
CHƯNG	CH Ư NG SP
CHƯƠNG	CH ƯƠ NG SP
CHƯỚC	CH ƯỚ C SP
CHƯỚNG	CH ƯỚ NG SP
CHƯỜM	CH ƯỜ M SP
CHƯỢC	CH ƯỢ C SP
CHẠCH	CH Ạ CH SP
CHẠM	CH Ạ M SP
CHẠN	CH Ạ N SP
CHẠNH	CH Ạ NH SP
CHẠP	CH Ạ P SP
CHẠY	CH ẠY SP
CHẢ	CH Ả SP
CHẢI	CH ẢI SP
CHẢO	CH ẢO SP
CHẢY	CH ẢY SP
CHẤM	CH Ấ M SP
CHẤN	CH Ấ N SP
CHẤP	CH Ấ P SP
CHẤT	CH Ấ T SP
CHẤU	CH ẤU SP
CHẦM	CH Ầ M SP
CHẦU	CH ẦU SP
CHẨM	CH Ẩ M SP
CHẨN	CH Ẩ N SP
CHẬM	CH Ậ M SP
CHẬP	CH Ậ P SP
CHẬT	CH Ậ T SP
CHẬU	CH ẬU SP
CHẮC	CH Ắ C SP
CHẮM	CH Ắ M SP
CHẮN	CH Ắ N SP
CHẮP	CH Ắ P SP
CHẮT	CH Ắ T SP
CHẰM	CH Ằ M SP
CHẰN	CH Ằ N SP
CHẰNG	CH Ằ NG SP
CHẲNG	CH Ẳ NG SP
CHẴN	CH Ẵ N SP
CHẶN	CH Ặ N SP
CHẶNG	CH Ặ NG SP
CHẶT	CH Ặ T SP
CHẸN	CH Ẹ N SP
CHẸO	CH ẸO SP
CHẸP	CH Ẹ P SP
CHẺ	CH Ẻ SP
CHẼ	CH Ẽ SP
CHẼN	CH Ẽ N SP
CHẾ	CH Ế SP
CHẾT	CH Ế T SP
CHỀ	CH Ề SP
CHỀNH	CH Ề NH SP
CHỂNH	CH Ể NH SP
CHỆCH	CH Ệ CH SP
CHỈ	CH Ỉ SP
CHỈNH	CH Ỉ NH SP
CHỊ	CH Ị SP
CHỊT	CH Ị T SP
CHỊU	CH ỊU SP
CHỌC	CH Ọ C SP
CHỌI	CH ỌI SP
CHỌN	CH Ọ N SP
CHỌT	CH Ọ T SP
CHỎ	CH Ỏ SP
CHỎM	CH Ỏ M SP
CHỎN	CH Ỏ N SP
CHỐC	CH Ố C SP
CHỐI	CH ỐI SP
CHỐN	CH Ố N SP
CHỐNG	CH Ố NG SP
CHỐT	CH Ố T SP
CHỒI	CH ỒI SP
CHỒM	CH Ồ M SP
CHỒN	CH Ồ N SP
CHỒNG	CH Ồ NG SP
CHỔI	CH ỔI SP
CHỖ	CH Ỗ SP
CHỘP	CH Ộ P SP
CHỚ	CH Ớ SP
CHỚI	CH ỚI SP
CHỜ	CH Ờ SP
CHỜN	CH Ờ N SP
CHỞ	CH Ở SP
CHỢ	CH Ợ SP
CHỢP	CH Ợ P SP
CHỢT	CH Ợ T SP
CHỤC	CH Ụ C SP
CHỤM	CH Ụ M SP
CHỤP	CH Ụ P SP
CHỦ	CH Ủ SP
CHỦNG	CH Ủ NG SP
CHỨ	CH Ứ SP
CHỨA	CH ỨA SP
CHỨC	CH Ứ C SP
CHỨNG	CH Ứ NG SP
CHỪ	CH Ừ SP
CHỪNG	CH Ừ NG SP
CHỬA	CH ỬA SP
CHỬI	CH ỬI SP
CHỬNG	CH Ử NG SP
CHỮ	CH Ữ SP
CHỮA	CH ỮA SP
CHỮNG	CH Ữ NG SP
CHỰC	CH Ự C SP
CO	C O SP
COI	C OI SP
CON	C O N SP
CONG	C O NG SP
CU	C U SP
CUA	C UA SP
CUN	C U N SP
CUNG	C U NG SP
CUÔNG	C UÔ NG SP
CUỐC	C UỐ C SP
CUỐI	C UỐI SP
CUỐN	C UỐ N SP
CUỐNG	C UỐ NG SP
CUỒN	C UỒ N SP
CUỒNG	C UỒ NG SP
CUỖM	C UỖ M SP
CUỘC	C UỘ C SP
CUỘI	C UỘI SP
CUỘN	C UỘ N SP
CÀ	C À SP
CÀI	C ÀI SP
CÀNG	C À NG SP
CÀNH	C À NH SP
CÀO	C ÀO SP
CÀU	C ÀU SP
CÀY	C ÀY SP
CÁ	C Á SP
CÁC	C Á C SP
CÁCH	C Á CH SP
CÁI	C ÁI SP
CÁM	C Á M SP
CÁN	C Á N SP
CÁNG	C Á NG SP
CÁNH	C Á NH SP
CÁO	C ÁO SP
CÁP	C Á P SP
CÁT	C Á T SP
CÁU	C ÁU SP
CÁY	C ÁY SP
CÂM	C Â M SP
CÂN	C Â N SP
CÂU	C ÂU SP
CÂY	C ÂY SP
CÃI	C ÃI SP
CÒ	C Ò SP
CÒI	C ÒI SP
CÒM	C Ò M SP
CÒN	C Ò N SP
CÒNG	C Ò NG SP
CÓ	C Ó SP
CÓC	C Ó C SP
CÓNG	C Ó NG SP
CÓP	C Ó P SP
CÓT	C Ó T SP
CÔ	C Ô SP
CÔI	C ÔI SP
CÔM	C Ô M SP
CÔN	C Ô N SP
CÔNG	C Ô NG SP
CÕI	C ÕI SP
CÕNG	C Õ NG SP
CÙ	C Ù SP
CÙI	C ÙI SP
CÙN	C Ù N SP
CÙNG	C Ù NG SP
CÚ	C Ú SP
CÚC	C Ú C SP
CÚI	C ÚI SP
CÚM	C Ú M SP
CÚNG	C Ú NG SP
CÚP	C Ú P SP
CÚT	C Ú T SP
CĂM	C Ă M SP
CĂN	C Ă N SP
CĂNG	C Ă NG SP
CŨ	C Ũ SP
CŨI	C ŨI SP
CŨN	C Ũ N SP
CŨNG	C Ũ NG SP
CƠ	C Ơ SP
CƠI	C ƠI SP
CƠM	C Ơ M SP
CƠN	C Ơ N SP
CƯ	C Ư SP
CƯA	C ƯA SP
CƯNG	C Ư NG SP
CƯU	C ƯU SP
CƯƠNG	C ƯƠ NG SP
CƯỚC	C ƯỚ C SP
CƯỚI	C ƯỚI SP
CƯỚP	C ƯỚ P SP
CƯỜI	C ƯỜI SP
CƯỜM	C ƯỜ M SP
CƯỜNG	C ƯỜ NG SP
CƯỠI	C ƯỠI SP
CƯỠNG	C ƯỠ NG SP
CẠC	C Ạ C SP
CẠCH	C Ạ CH SP
CẠM	C Ạ M SP
CẠN	C Ạ N SP
CẠNH	C Ạ NH SP
CẠO	C ẠO SP
CẠP	C Ạ P SP
CẠU	C ẠU SP
CẠY	C ẠY SP
CẢ	C Ả SP
CẢI	C ẢI SP
CẢM	C Ả M SP
CẢN	C Ả N SP
CẢNG	C Ả NG SP
CẢNH	C Ả NH SP
CẢO	C ẢO SP
CẤM	C Ấ M SP
CẤP	C Ấ P SP
CẤT	C Ấ T SP
CẤU	C ẤU SP
CẤY	C ẤY SP
CẦM	C Ầ M SP
CẦN	C Ầ N SP
CẦU	C ẦU SP
CẦY	C ẦY SP
CẨM	C Ẩ M SP
CẨN	C Ẩ N SP
CẨU	C ẨU SP
CẪNG	C Ẫ NG SP
CẬN	C Ậ N SP
CẬP	C Ậ P SP
CẬT	C Ậ T SP
CẬU	C ẬU SP
CẬY	C ẬY SP
CẮC	C Ắ C SP
CẮM	C Ắ M SP
CẮN	C Ắ N SP
CẮP	C Ắ P SP
CẮT	C Ắ T SP
CẰM	C Ằ M SP
CẰN	C Ằ N SP
CẲNG	C Ẳ NG SP
CẶM	C Ặ M SP
CẶN	C Ặ N SP
CẶP	C Ặ P SP
CỌ	C Ọ SP
CỌC	C Ọ C SP
CỌN	C Ọ N SP
CỌNG	C Ọ NG SP
CỌP	C Ọ P SP
CỌT	C Ọ T SP
CỎ	C Ỏ SP
CỎI	C ỎI SP
CỎM	C Ỏ M SP
CỐ	C Ố SP
CỐC	C Ố C SP
CỐI	C ỐI SP
CỐM	C Ố M SP
CỐNG	C Ố NG SP
CỐT	C Ố T SP
CỒ	C Ồ SP
CỒM	C Ồ M SP
CỒN	C Ồ N SP
CỒNG	C Ồ NG SP
CỔ	C Ổ SP
CỔNG	C Ổ NG SP
CỖ	C Ỗ SP
CỖI	C ỖI SP
CỘ	C Ộ SP
CỘI	C ỘI SP
CỘNG	C Ộ NG SP
CỘP	C Ộ P SP
CỘT	C Ộ T SP
CỚ	C Ớ SP
CỜ	C Ờ SP
CỜI	C ỜI SP
CỞI	C ỞI SP
CỠ	C Ỡ SP
CỢT	C Ợ T SP
CỤ	C Ụ SP
CỤC	C Ụ C SP
CỤI	C ỤI SP
CỤM	C Ụ M SP
CỤP	C Ụ P SP
CỤT	C Ụ T SP
CỦ	C Ủ SP
CỦA	C ỦA SP
CỦI	C ỦI SP
CỦNG	C Ủ NG SP
CỨ	C Ứ SP
CỨA	C ỨA SP
CỨNG	C Ứ NG SP
CỨU	C ỨU SP
CỪ	C Ừ SP
CỪU	C ỪU SP
CỬ	C Ử SP
CỬA	C ỬA SP
CỬI	C ỬI SP
CỬU	C ỬU SP
CỮ	C Ữ SP
CỰ	C Ự SP
CỰA	C ỰA SP
CỰC	C Ự C SP
CỰU	C ỰU SP
D	D  SP
DA	D A SP
DAI	D AI SP
DANG	D A NG SP
DANH	D A NH SP
DAO	D AO SP
DI	D I SP
DIM	D I M SP
DINH	D I NH SP
DIÊM	D IÊ M SP
DIÊN	D IÊ N SP
DIÊU	D IÊU SP
DIẾC	D IẾ C SP
DIẾT	D IẾ T SP
DIẾU	D IẾU SP
DIỀU	D IỀU SP
DIỄM	D IỄ M SP
DIỄN	D IỄ N SP
DIỆC	D IỆ C SP
DIỆM	D IỆ M SP
DIỆN	D IỆ N SP
DIỆP	D IỆ P SP
DIỆT	D IỆ T SP
DIỆU	D IỆU SP
DO	D O SP
DOANH	D OA NH SP
DOI	D OI SP
DONG	D O NG SP
DOÃN	D OÃ N SP
DU	D U SP
DUA	D UA SP
DUNG	D U NG SP
DUY	D UY SP
DUYÊN	D UYÊ N SP
DUYỆT	D UYỆ T SP
DUỖI	D UỖI SP
DÀ	D À SP
DÀI	D ÀI SP
DÀN	D À N SP
DÀNG	D À NG SP
DÀNH	D À NH SP
DÀO	D ÀO SP
DÀY	D ÀY SP
DÁC	D Á C SP
DÁM	D Á M SP
DÁN	D Á N SP
DÁNG	D Á NG SP
DÁO	D ÁO SP
DÂM	D Â M SP
DÂN	D Â N SP
DÂNG	D Â NG SP
DÂU	D ÂU SP
DÂY	D ÂY SP
DÃ	D Ã SP
DÃNG	D Ã NG SP
DÃY	D ÃY SP
DÈ	D È SP
DÉP	D É P SP
DÊ	D Ê SP
DÌ	D Ì SP
DÌU	D ÌU SP
DÍ	D Í SP
DÍNH	D Í NH SP
DÒ	D Ò SP
DÒI	D ÒI SP
DÒM	D Ò M SP
DÒNG	D Ò NG SP
DÓ	D Ó SP
DÓC	D Ó C SP
DÓM	D Ó M SP
DÔI	D ÔI SP
DÔNG	D Ô NG SP
DÕI	D ÕI SP
DÕNG	D Õ NG SP
DÙ	D Ù SP
DÙI	D ÙI SP
DÙNG	D Ù NG SP
DÚM	D Ú M SP
DĂM	D Ă M SP
DĂN	D Ă N SP
DĨ	D Ĩ SP
DĨA	D ĨA SP
DŨNG	D Ũ NG SP
DƠI	D ƠI SP
DƯ	D Ư SP
DƯA	D ƯA SP
DƯNG	D Ư NG SP
DƯƠNG	D ƯƠ NG SP
DƯỚI	D ƯỚI SP
DƯỜNG	D ƯỜ NG SP
DƯỠNG	D ƯỠ NG SP
DƯỢC	D ƯỢ C SP
DƯỢT	D ƯỢ T SP
DẠ	D Ạ SP
DẠC	D Ạ C SP
DẠI	D ẠI SP
DẠM	D Ạ M SP
DẠN	D Ạ N SP
DẠNG	D Ạ NG SP
DẠO	D ẠO SP
DẠT	D Ạ T SP
DẠY	D ẠY SP
DẢ	D Ả SP
DẢI	D ẢI SP
DẤN	D Ấ N SP
DẤP	D Ấ P SP
DẤU	D ẤU SP
DẤY	D ẤY SP
DẦM	D Ầ M SP
DẦN	D Ầ N SP
DẦU	D ẦU SP
DẨN	D Ẩ N SP
DẪM	D Ẫ M SP
DẪN	D Ẫ N SP
DẪU	D ẪU SP
DẪY	D ẪY SP
DẬM	D Ậ M SP
DẬP	D Ậ P SP
DẬY	D ẬY SP
DẮT	D Ắ T SP
DẰN	D Ằ N SP
DẰNG	D Ằ NG SP
DẲNG	D Ẳ NG SP
DẶC	D Ặ C SP
DẶM	D Ặ M SP
DẶN	D Ặ N SP
DẸP	D Ẹ P SP
DẸT	D Ẹ T SP
DẺO	D ẺO SP
DẾ	D Ế SP
DỀ	D Ề SP
DỀNH	D Ề NH SP
DỄ	D Ễ SP
DỆT	D Ệ T SP
DỊ	D Ị SP
DỊCH	D Ị CH SP
DỊP	D Ị P SP
DỊU	D ỊU SP
DỌA	D ỌA SP
DỌC	D Ọ C SP
DỌN	D Ọ N SP
DỎNG	D Ỏ NG SP
DỐC	D Ố C SP
DỐI	D ỐI SP
DỐT	D Ố T SP
DỒI	D ỒI SP
DỒN	D Ồ N SP
DỖ	D Ỗ SP
DỖI	D ỖI SP
DỘI	D ỘI SP
DỘT	D Ộ T SP
DỚ	D Ớ SP
DỜI	D ỜI SP
DỜN	D Ờ N SP
DỞ	D Ở SP
DỠ	D Ỡ SP
DỤ	D Ụ SP
DỤC	D Ụ C SP
DỤNG	D Ụ NG SP
DỨA	D ỨA SP
DỨT	D Ứ T SP
DỪA	D ỪA SP
DỪNG	D Ừ NG SP
DỬ	D Ử SP
DỬNG	D Ử NG SP
DỮ	D Ữ SP
DỰ	D Ự SP
DỰA	D ỰA SP
DỰC	D Ự C SP
DỰNG	D Ự NG SP
E	E SP
EM	E M SP
EO	EO SP
GA	G A SP
GAI	G AI SP
GAM	G A M SP
GAN	G A N SP
GANG	G A NG SP
GANH	G A NH SP
GAO	G AO SP
GAY	G AY SP
GEN	G E N SP
GHE	GH E SP
GHEN	GH E N SP
GHI	GH I SP
GHIM	GH I M SP
GHIỀN	GH IỀ N SP
GHÈ	GH È SP
GHÈN	GH È N SP
GHÉ	GH É SP
GHÉM	GH É M SP
GHÉP	GH É P SP
GHÉT	GH É T SP
GHÊ	GH Ê SP
GHÌ	GH Ì SP
GHÌM	GH Ì M SP
GHẸ	GH Ẹ SP
GHẸO	GH ẸO SP
GHẺ	GH Ẻ SP
GHẼ	GH Ẽ SP
GHẾ	GH Ế SP
GHỀ	GH Ề SP
GHỀNH	GH Ề NH SP
GHỂNH	GH Ể NH SP
GIA	GI A SP
GIAI	GI AI SP
GIAM	GI A M SP
GIAN	GI A N SP
GIANG	GI A NG SP
GIANH	GI A NH SP
GIAO	GI AO SP
GIEO	GI EO SP
GION	GI O N SP
GIUA	GI UA SP
GIUN	GI U N SP
GIÀ	GI À SP
GIÀN	GI À N SP
GIÀNH	GI À NH SP
GIÀU	GI ÀU SP
GIÀY	GI ÀY SP
GIÁ	GI Á SP
GIÁC	GI Á C SP
GIÁM	GI Á M SP
GIÁN	GI Á N SP
GIÁNG	GI Á NG SP
GIÁO	GI ÁO SP
GIÁP	GI Á P SP
GIÂY	GI ÂY SP
GIÃ	GI Ã SP
GIÃN	GI Ã N SP
GIÃY	GI ÃY SP
GIÈM	GI È M SP
GIÉ	GI É SP
GIÊNG	GI Ê NG SP
GIÒ	GI Ò SP
GIÒN	GI Ò N SP
GIÓ	GI Ó SP
GIÓN	GI Ó N SP
GIÓNG	GI Ó NG SP
GIÔNG	GI Ô NG SP
GIÙM	GI Ù M SP
GIÚ	GI Ú SP
GIÚP	GI Ú P SP
GIĂM	GI Ă M SP
GIĂNG	GI Ă NG SP
GIŨ	GI Ũ SP
GIŨA	GI ŨA SP
GIƠ	GI Ơ SP
GIƯƠNG	GI ƯƠ NG SP
GIƯỚNG	GI ƯỚ NG SP
GIƯỜNG	GI ƯỜ NG SP
GIẠT	GI Ạ T SP
GIẢ	GI Ả SP
GIẢI	GI ẢI SP
GIẢM	GI Ả M SP
GIẢN	GI Ả N SP
GIẢNG	GI Ả NG SP
GIẢNH	GI Ả NH SP
GIẤC	GI Ấ C SP
GIẤM	GI Ấ M SP
GIẤP	GI Ấ P SP
GIẤU	GI ẤU SP
GIẤY	GI ẤY SP
GIẦM	GI Ầ M SP
GIẦN	GI Ầ N SP
GIẦY	GI ẦY SP
GIẪM	GI Ẫ M SP
GIẬM	GI Ậ M SP
GIẬN	GI Ậ N SP
GIẬP	GI Ậ P SP
GIẬT	GI Ậ T SP
GIẮT	GI Ắ T SP
GIẰM	GI Ằ M SP
GIẰNG	GI Ằ NG SP
GIẶC	GI Ặ C SP
GIẶM	GI Ặ M SP
GIẶN	GI Ặ N SP
GIẶT	GI Ặ T SP
GIẸO	GI ẸO SP
GIẾM	GI Ế M SP
GIẾNG	GI Ế NG SP
GIẾT	GI Ế T SP
GIỀNG	GI Ề NG SP
GIỄU	GI ỄU SP
GIỌ	GI Ọ SP
GIỌNG	GI Ọ NG SP
GIỌT	GI Ọ T SP
GIỎ	GI Ỏ SP
GIỎI	GI ỎI SP
GIỎN	GI Ỏ N SP
GIỐNG	GI Ố NG SP
GIỒNG	GI Ồ NG SP
GIỖ	GI Ỗ SP
GIỚI	GI ỚI SP
GIỜ	GI Ờ SP
GIỜI	GI ỜI SP
GIỞ	GI Ở SP
GIỠN	GI Ỡ N SP
GIỤA	GI ỤA SP
GIỤC	GI Ụ C SP
GIỦI	GI ỦI SP
GIỮ	GI Ữ SP
GIỮA	GI ỮA SP
GIỰT	GI Ự T SP
GO	G O SP
GOM	G O M SP
GU	G U SP
GUỐC	G UỐ C SP
GUỘC	G UỘ C SP
GÀ	G À SP
GÀI	G ÀI SP
GÀN	G À N SP
GÀNG	G À NG SP
GÀNH	G À NH SP
GÀO	G ÀO SP
GÀU	G ÀU SP
GÁC	G Á C SP
GÁI	G ÁI SP
GÁN	G Á N SP
GÁNH	G Á NH SP
GÁO	G ÁO SP
GÁP	G Á P SP
GÁY	G ÁY SP
GÂN	G Â N SP
GÂY	G ÂY SP
GÃ	G Ã SP
GÃI	G ÃI SP
GÃY	G ÃY SP
GÌ	G Ì SP
GÌN	G Ì N SP
GÍ	G Í SP
GÒ	G Ò SP
GÒN	G Ò N SP
GÓA	G ÓA SP
GÓC	G Ó C SP
GÓI	G ÓI SP
GÓP	G Ó P SP
GÓT	G Ó T SP
GÔ	G Ô SP
GÔN	G Ô N SP
GÔNG	G Ô NG SP
GÕ	G Õ SP
GÙ	G Ù SP
GÚ	G Ú SP
GÚT	G Ú T SP
GĂM	G Ă M SP
GŨI	G ŨI SP
GƯƠM	G ƯƠ M SP
GƯƠNG	G ƯƠ NG SP
GƯỜM	G ƯỜ M SP
GƯỜNG	G ƯỜ NG SP
GƯỢNG	G ƯỢ NG SP
GẠ	G Ạ SP
GẠCH	G Ạ CH SP
GẠN	G Ạ N SP
GẠO	G ẠO SP
GẠT	G Ạ T SP
GẢ	G Ả SP
GẢY	G ẢY SP
GẤP	G Ấ P SP
GẤU	G ẤU SP
GẤY	G ẤY SP
GẦM	G Ầ M SP
GẦN	G Ầ N SP
GẦU	G ẦU SP
GẦY	G ẦY SP
GẪM	G Ẫ M SP
GẪU	G ẪU SP
GẬP	G Ậ P SP
GẬT	G Ậ T SP
GẬY	G ẬY SP
GẮM	G Ắ M SP
GẮN	G Ắ N SP
GẮNG	G Ắ NG SP
GẮP	G Ắ P SP
GẮT	G Ắ T SP
GẰN	G Ằ N SP
GẶM	G Ặ M SP
GẶNG	G Ặ NG SP
GẶP	G Ặ P SP
GẶT	G Ặ T SP
GỈ	G Ỉ SP
GỌI	G ỌI SP
GỌN	G Ọ N SP
GỌT	G Ọ T SP
GỎI	G ỎI SP
GỎNG	G Ỏ NG SP
GỐC	G Ố C SP
GỐI	G ỐI SP
GỐM	G Ố M SP
GỒ	G Ồ SP
GỒM	G Ồ M SP
GỒNG	G Ồ NG SP
GỔ	G Ổ SP
GỖ	G Ỗ SP
GỘI	G ỘI SP
GỘP	G Ộ P SP
GỚM	G Ớ M SP
GỜM	G Ờ M SP
GỞI	G ỞI SP
GỠ	G Ỡ SP
GỢI	G ỢI SP
GỢN	G Ợ N SP
GỢT	G Ợ T SP
GỤC	G Ụ C SP
GỬI	G ỬI SP
H	H  SP
HA	H A SP
HAI	H AI SP
HAM	H A M SP
HAN	H A N SP
HANG	H A NG SP
HAO	H AO SP
HAY	H AY SP
HE	H E SP
HEM	H E M SP
HEN	H E N SP
HEO	H EO SP
HI	H I SP
HIA	H IA SP
HIU	H IU SP
HIÊN	H IÊ N SP
HIÊNG	H IÊ NG SP
HIẾM	H IẾ M SP
HIẾN	H IẾ N SP
HIẾP	H IẾ P SP
HIẾU	H IẾU SP
HIỀN	H IỀ N SP
HIỂM	H IỂ M SP
HIỂN	H IỂ N SP
HIỂU	H IỂU SP
HIỆN	H IỆ N SP
HIỆP	H IỆ P SP
HIỆU	H IỆU SP
HO	H O SP
HOA	H OA SP
HOAN	H OA N SP
HOANG	H OA NG SP
HOAY	H OAY SP
HOI	H OI SP
HOM	H O M SP
HOÀ	H OÀ SP
HOÀI	H OÀI SP
HOÀN	H OÀ N SP
HOÀNG	H OÀ NG SP
HOÀNH	H OÀ NH SP
HOÁ	H OÁ SP
HOÁC	H OÁ C SP
HOÃN	H OÃ N SP
HOÉT	H OÉ T SP
HOẠ	H OẠ SP
HOẠCH	H OẠ CH SP
HOẠI	H OẠI SP
HOẠN	H OẠ N SP
HOẠT	H OẠ T SP
HOẢNG	H OẢ NG SP
HOẮC	H OẮ C SP
HOẮT	H OẮ T SP
HOẲN	H OẲ N SP
HOẶC	H OẶ C SP
HU	H U SP
HUN	H U N SP
HUNG	H U NG SP
HUY	H UY SP
HUYNH	H UY NH SP
HUYÊN	H UYÊ N SP
HUYẾT	H UYẾ T SP
HUYỀN	H UYỀ N SP
HUYỄN	H UYỄ N SP
HUYỆN	H UYỆ N SP
HUYỆT	H UYỆ T SP
HUÂN	H UÂ N SP
HUÊ	H UÊ SP
HUÝT	H UÝ T SP
HUƠ	H UƠ SP
HUẤN	H UẤ N SP
HUẾ	H UẾ SP
HUẾCH	H UẾ CH SP
HUỀ	H UỀ SP
HUỆ	H UỆ SP
HUỐNG	H UỐ NG SP
HUỲNH	H UỲ NH SP
HUỶ	H UỶ SP
HY	H Y SP
HÀ	H À SP
HÀI	H ÀI SP
HÀM	H À M SP
HÀN	H À N SP
HÀNG	H À NG SP
HÀNH	H À NH SP
HÀO	H ÀO SP
HÀU	H ÀU SP
HÁ	H Á SP
HÁI	H ÁI SP
HÁM	H Á M SP
HÁN	H Á N SP
HÁNG	H Á NG SP
HÁO	H ÁO SP
HÁT	H Á T SP
HÂM	H Â M SP
HÂN	H Â N SP
HÃI	H ÃI SP
HÃN	H Ã N SP
HÃNG	H Ã NG SP
HÃNH	H Ã NH SP
HÃO	H ÃO SP
HÃY	H ÃY SP
HÈ	H È SP
HÈN	H È N SP
HÉ	H É SP
HÉO	H ÉO SP
HÉT	H É T SP
HÊN	H Ê N SP
HÊNH	H Ê NH SP
HÌ	H Ì SP
HÌNH	H Ì NH SP
HÍ	H Í SP
HÍT	H Í T SP
HÒ	H Ò SP
HÒA	H ÒA SP
HÒN	H Ò N SP
HÓA	H ÓA SP
HÓC	H Ó C SP
HÓI	H ÓI SP
HÓM	H Ó M SP
HÓNG	H Ó NG SP
HÓT	H Ó T SP
HÔ	H Ô SP
HÔI	H ÔI SP
HÔM	H Ô M SP
HÔN	H Ô N SP
HÔNG	H Ô NG SP
HÙA	H ÙA SP
HÙN	H Ù N SP
HÙNG	H Ù NG SP
HÚ	H Ú SP
HÚC	H Ú C SP
HÚI	H ÚI SP
HÚNG	H Ú NG SP
HÚP	H Ú P SP
HÚT	H Ú T SP
HÚY	H ÚY SP
HĂM	H Ă M SP
HĂNG	H Ă NG SP
HĨNH	H Ĩ NH SP
HŨ	H Ũ SP
HŨM	H Ũ M SP
HƠI	H ƠI SP
HƠN	H Ơ N SP
HƯ	H Ư SP
HƯNG	H Ư NG SP
HƯU	H ƯU SP
HƯƠNG	H ƯƠ NG SP
HƯƠU	H ƯƠU SP
HƯỚC	H ƯỚ C SP
HƯỚM	H ƯỚ M SP
HƯỚNG	H ƯỚ NG SP
HƯỜNG	H ƯỜ NG SP
HƯỞNG	H ƯỞ NG SP
HẠ	H Ạ SP
HẠC	H Ạ C SP
HẠCH	H Ạ CH SP
HẠI	H ẠI SP
HẠM	H Ạ M SP
HẠN	H Ạ N SP
HẠNG	H Ạ NG SP
HẠNH	H Ạ NH SP
HẠO	H ẠO SP
HẠP	H Ạ P SP
HẠT	H Ạ T SP
HẢ	H Ả SP
HẢI	H ẢI SP
HẢM	H Ả M SP
HẢO	H ẢO SP
HẤNG	H Ấ NG SP
HẤP	H Ấ P SP
HẤT	H Ấ T SP
HẤU	H ẤU SP
HẦM	H Ầ M SP
HẦU	H ẦU SP
HẦY	H ẦY SP
HẨM	H Ẩ M SP
HẪNG	H Ẫ NG SP
HẬN	H Ậ N SP
HẬP	H Ậ P SP
HẬU	H ẬU SP
HẮC	H Ắ C SP
HẮN	H Ắ N SP
HẮNG	H Ắ NG SP
HẮT	H Ắ T SP
HẰN	H Ằ N SP
HẰNG	H Ằ NG SP
HẲN	H Ẳ N SP
HẴNG	H Ẵ NG SP
HẶC	H Ặ C SP
HẸ	H Ẹ SP
HẸN	H Ẹ N SP
HẸP	H Ẹ P SP
HẺM	H Ẻ M SP
HẾN	H Ế N SP
HẾT	H Ế T SP
HỀ	H Ề SP
HỂ	H Ể SP
HỂN	H Ể N SP
HỂNH	H Ể NH SP
HỄ	H Ễ SP
HỆ	H Ệ SP
HỆT	H Ệ T SP
HỈ	H Ỉ SP
HỈNH	H Ỉ NH SP
HỌ	H Ọ SP
HỌA	H ỌA SP
HỌC	H Ọ C SP
HỌNG	H Ọ NG SP
HỌP	H Ọ P SP
HỎA	H ỎA SP
HỎI	H ỎI SP
HỎM	H Ỏ M SP
HỎNG	H Ỏ NG SP
HỐ	H Ố SP
HỐC	H Ố C SP
HỐI	H ỐI SP
HỐT	H Ố T SP
HỒ	H Ồ SP
HỒI	H ỒI SP
HỒN	H Ồ N SP
HỒNG	H Ồ NG SP
HỔ	H Ổ SP
HỔI	H ỔI SP
HỔM	H Ổ M SP
HỔN	H Ổ N SP
HỔNG	H Ổ NG SP
HỖ	H Ỗ SP
HỖN	H Ỗ N SP
HỘ	H Ộ SP
HỘC	H Ộ C SP
HỘI	H ỘI SP
HỘN	H Ộ N SP
HỘP	H Ộ P SP
HỘT	H Ộ T SP
HỚ	H Ớ SP
HỚN	H Ớ N SP
HỚP	H Ớ P SP
HỚT	H Ớ T SP
HỜN	H Ờ N SP
HỞ	H Ở SP
HỞI	H ỞI SP
HỢI	H ỢI SP
HỢM	H Ợ M SP
HỢP	H Ợ P SP
HỤ	H Ụ SP
HỤC	H Ụ C SP
HỤI	H ỤI SP
HỤT	H Ụ T SP
HỦ	H Ủ SP
HỦY	H ỦY SP
HỨA	H ỨA SP
HỨC	H Ứ C SP
HỨNG	H Ứ NG SP
HỪ	H Ừ SP
HỪNG	H Ừ NG SP
HỮU	H ỮU SP
HỰ	H Ự SP
HỰC	H Ự C SP
HỰU	H ỰU SP
I	I SP
IM	I M SP
IN	I N SP
INH	I NH SP
K	K  SP
KA	K A SP
KEM	K E M SP
KEN	K E N SP
KEO	K EO SP
KHA	KH A SP
KHAI	KH AI SP
KHAN	KH A N SP
KHANG	KH A NG SP
KHANH	KH A NH SP
KHAO	KH AO SP
KHE	KH E SP
KHEN	KH E N SP
KHEO	KH EO SP
KHI	KH I SP
KHINH	KH I NH SP
KHIÊM	KH IÊ M SP
KHIÊN	KH IÊ N SP
KHIÊNG	KH IÊ NG SP
KHIÊU	KH IÊU SP
KHIẾM	KH IẾ M SP
KHIẾN	KH IẾ N SP
KHIẾP	KH IẾ P SP
KHIẾT	KH IẾ T SP
KHIẾU	KH IẾU SP
KHIỂN	KH IỂ N SP
KHO	KH O SP
KHOA	KH OA SP
KHOAI	KH OAI SP
KHOAN	KH OA N SP
KHOANG	KH OA NG SP
KHOANH	KH OA NH SP
KHOE	KH OE SP
KHOM	KH O M SP
KHOÁ	KH OÁ SP
KHOÁC	KH OÁ C SP
KHOÁI	KH OÁI SP
KHOÁN	KH OÁ N SP
KHOÁT	KH OÁ T SP
KHOÈO	KH OÈO SP
KHOÉT	KH OÉ T SP
KHOĂN	KH OĂ N SP
KHOẢI	KH OẢI SP
KHOẢN	KH OẢ N SP
KHOẢNG	KH OẢ NG SP
KHOẢNH	KH OẢ NH SP
KHOẮT	KH OẮ T SP
KHOẺ	KH OẺ SP
KHU	KH U SP
KHUA	KH UA SP
KHUM	KH U M SP
KHUNG	KH U NG SP
KHUY	KH UY SP
KHUYA	KH UYA SP
KHUYNH	KH UY NH SP
KHUYÊN	KH UYÊ N SP
KHUYẾN	KH UYẾ N SP
KHUYẾT	KH UYẾ T SP
KHUÂN	KH UÂ N SP
KHUÂNG	KH UÂ NG SP
KHUÂY	KH UÂY SP
KHUÔN	KH UÔ N SP
KHUẤT	KH UẤ T SP
KHUẤY	KH UẤY SP
KHUẨN	KH UẨ N SP
KHUỲNH	KH UỲ NH SP
KHUỶU	KH UỶU SP
KHÀN	KH À N SP
KHÀNG	KH À NG SP
KHÁ	KH Á SP
KHÁC	KH Á C SP
KHÁCH	KH Á CH SP
KHÁI	KH ÁI SP
KHÁM	KH Á M SP
KHÁN	KH Á N SP
KHÁNG	KH Á NG SP
KHÁNH	KH Á NH SP
KHÁO	KH ÁO SP
KHÁP	KH Á P SP
KHÁT	KH Á T SP
KHÂM	KH Â M SP
KHÂU	KH ÂU SP
KHÈ	KH È SP
KHÈN	KH È N SP
KHÈO	KH ÈO SP
KHÉN	KH É N SP
KHÉO	KH ÉO SP
KHÉP	KH É P SP
KHÉT	KH É T SP
KHÊ	KH Ê SP
KHÍ	KH Í SP
KHÍA	KH ÍA SP
KHÍCH	KH Í CH SP
KHÍT	KH Í T SP
KHÍU	KH ÍU SP
KHÒ	KH Ò SP
KHÓ	KH Ó SP
KHÓA	KH ÓA SP
KHÓC	KH Ó C SP
KHÓE	KH ÓE SP
KHÓI	KH ÓI SP
KHÔ	KH Ô SP
KHÔI	KH ÔI SP
KHÔN	KH Ô N SP
KHÔNG	KH Ô NG SP
KHÙ	KH Ù SP
KHÚ	KH Ú SP
KHÚC	KH Ú C SP
KHÚM	KH Ú M SP
KHĂM	KH Ă M SP
KHĂN	KH Ă N SP
KHƠ	KH Ơ SP
KHƠI	KH ƠI SP
KHƯ	KH Ư SP
KHƯƠM	KH ƯƠ M SP
KHƯƠN	KH ƯƠ N SP
KHƯƠNG	KH ƯƠ NG SP
KHƯỚC	KH ƯỚ C SP
KHẠC	KH Ạ C SP
KHẠNG	KH Ạ NG SP
KHẢ	KH Ả SP
KHẢI	KH ẢI SP
KHẢO	KH ẢO SP
KHẢY	KH ẢY SP
KHẤN	KH Ấ N SP
KHẤP	KH Ấ P SP
KHẤT	KH Ấ T SP
KHẤU	KH ẤU SP
KHẨN	KH Ẩ N SP
KHẨU	KH ẨU SP
KHẬT	KH Ậ T SP
KHẮC	KH Ắ C SP
KHẮM	KH Ắ M SP
KHẮNG	KH Ắ NG SP
KHẮP	KH Ắ P SP
KHẮT	KH Ắ T SP
KHẲM	KH Ẳ M SP
KHẲNG	KH Ẳ NG SP
KHẺ	KH Ẻ SP
KHẼ	KH Ẽ SP
KHẾ	KH Ế SP
KHỀU	KH ỀU SP
KHỆ	KH Ệ SP
KHỆNH	KH Ệ NH SP
KHỈ	KH Ỉ SP
KHỊT	KH Ị T SP
KHỎA	KH ỎA SP
KHỎE	KH ỎE SP
KHỎI	KH ỎI SP
KHỐ	KH Ố SP
KHỐC	KH Ố C SP
KHỐI	KH ỐI SP
KHỐN	KH Ố N SP
KHỐNG	KH Ố NG SP
KHỔ	KH Ổ SP
KHỔNG	KH Ổ NG SP
KHỚ	KH Ớ SP
KHỚP	KH Ớ P SP
KHỜ	KH Ờ SP
KHỞI	KH ỞI SP
KHỤ	KH Ụ SP
KHỦNG	KH Ủ NG SP
KHỨ	KH Ứ SP
KHỨU	KH ỨU SP
KHỪ	KH Ừ SP
KHỰNG	KH Ự NG SP
KI	K I SP
KIA	K IA SP
KIM	K I M SP
KINH	K I NH SP
KIÊM	K IÊ M SP
KIÊN	K IÊ N SP
KIÊNG	K IÊ NG SP
KIÊU	K IÊU SP
KIẾM	K IẾ M SP
KIẾN	K IẾ N SP
KIẾP	K IẾ P SP
KIỀM	K IỀ M SP
KIỀN	K IỀ N SP
KIỀNG	K IỀ NG SP
KIỀU	K IỀU SP
KIỂM	K IỂ M SP
KIỂNG	K IỂ NG SP
KIỂU	K IỂU SP
KIỆM	K IỆ M SP
KIỆN	K IỆ N SP
KIỆT	K IỆ T SP
KIỆU	K IỆU SP
KO	K O SP
KY	K Y SP
KÈ	K È SP
KÈM	K È M SP
KÈN	K È N SP
KÈO	K ÈO SP
KÉM	K É M SP
KÉN	K É N SP
KÉO	K ÉO SP
KÉP	K É P SP
KÉT	K É T SP
KÊ	K Ê SP
KÊNH	K Ê NH SP
KÊU	K ÊU SP
KÌ	K Ì SP
KÌA	K ÌA SP
KÌM	K Ì M SP
KÌNH	K Ì NH SP
KÍ	K Í SP
KÍCH	K Í CH SP
KÍN	K Í N SP
KÍNH	K Í NH SP
KÍP	K Í P SP
KÍT	K Í T SP
KÝ	K Ý SP
KĨ	K Ĩ SP
KẸN	K Ẹ N SP
KẸO	K ẸO SP
KẸP	K Ẹ P SP
KẸT	K Ẹ T SP
KẺ	K Ẻ SP
KẺNG	K Ẻ NG SP
KẺO	K ẺO SP
KẼ	K Ẽ SP
KẼM	K Ẽ M SP
KẼO	K ẼO SP
KẾ	K Ế SP
KẾCH	K Ế CH SP
KẾT	K Ế T SP
KỀ	K Ề SP
KỀN	K Ề N SP
KỀNH	K Ề NH SP
KỂ	K Ể SP
KỆ	K Ệ SP
KỆNH	K Ệ NH SP
KỈ	K Ỉ SP
KỈNH	K Ỉ NH SP
KỊ	K Ị SP
KỊCH	K Ị CH SP
KỊP	K Ị P SP
KỊT	K Ị T SP
KỲ	K Ỳ SP
KỴ	K Ỵ SP
KỶ	K Ỷ SP
KỸ	K Ỹ SP
LA	L A SP
LAI	L AI SP
LAM	L A M SP
LAN	L A N SP
LANG	L A NG SP
LANH	L A NH SP
LAO	L AO SP
LAU	L AU SP
LAY	L AY SP
LE	L E SP
LEM	L E M SP
LEN	L E N SP
LEO	L EO SP
LI	L I SP
LIA	L IA SP
LIM	L I M SP
LIN	L I N SP
LINH	L I NH SP
LIU	L IU SP
LIÊM	L IÊ M SP
LIÊN	L IÊ N SP
LIÊNG	L IÊ NG SP
LIÊU	L IÊU SP
LIẾC	L IẾ C SP
LIẾM	L IẾ M SP
LIẾN	L IẾ N SP
LIẾNG	L IẾ NG SP
LIỀM	L IỀ M SP
LIỀN	L IỀ N SP
LIỀU	L IỀU SP
LIỄU	L IỄU SP
LIỆNG	L IỆ NG SP
LIỆT	L IỆ T SP
LIỆU	L IỆU SP
LO	L O SP
LOA	L OA SP
LOAN	L OA N SP
LOANH	L OA NH SP
LOAY	L OAY SP
LOI	L OI SP
LOM	L O M SP
LONG	L O NG SP
LOÀI	L OÀI SP
LOÀN	L OÀ N SP
LOÀNG	L OÀ NG SP
LOÃNG	L OÃ NG SP
LOÉ	L OÉ SP
LOÉT	L OÉ T SP
LOẠI	L OẠI SP
LOẠN	L OẠ N SP
LOẠNG	L OẠ NG SP
LOẠT	L OẠ T SP
LOẢNG	L OẢ NG SP
LOẮT	L OẮ T SP
LOẰNG	L OẰ NG SP
LU	L U SP
LUI	L UI SP
LUNG	L U NG SP
LUYẾN	L UYẾ N SP
LUYỆN	L UYỆ N SP
LUÂN	L UÂ N SP
LUÔN	L UÔ N SP
LUẨN	L UẨ N SP
LUẬN	L UẬ N SP
LUẬT	L UẬ T SP
LUỐNG	L UỐ NG SP
LUỒN	L UỒ N SP
LUỒNG	L UỒ NG SP
LUỖNG	L UỖ NG SP
LUỘC	L UỘ C SP
LY	L Y SP
LÀ	L À SP
LÀI	L ÀI SP
LÀM	L À M SP
LÀN	L À N SP
LÀNG	L À NG SP
LÀNH	L À NH SP
LÀO	L ÀO SP
LÀU	L ÀU SP
LÁ	L Á SP
LÁC	L Á C SP
LÁCH	L Á CH SP
LÁI	L ÁI SP
LÁNG	L Á NG SP
LÁNH	L Á NH SP
LÁO	L ÁO SP
LÁP	L Á P SP
LÁT	L Á T SP
LÁU	L ÁU SP
LÁY	L ÁY SP
LÂM	L Â M SP
LÂN	L Â N SP
LÂNG	L Â NG SP
LÂU	L ÂU SP
LÂY	L ÂY SP
LÃ	L Ã SP
LÃI	L ÃI SP
LÃM	L Ã M SP
LÃN	L Ã N SP
LÃNG	L Ã NG SP
LÃNH	L Ã NH SP
LÃO	L ÃO SP
LÈ	L È SP
LÈO	L ÈO SP
LÉ	L É SP
LÉC	L É C SP
LÉM	L É M SP
LÉN	L É N SP
LÉNG	L É NG SP
LÉO	L ÉO SP
LÉP	L É P SP
LÉT	L É T SP
LÊ	L Ê SP
LÊN	L Ê N SP
LÊNH	L Ê NH SP
LÊU	L ÊU SP
LÌ	L Ì SP
LÌA	L ÌA SP
LÌM	L Ì M SP
LÍ	L Í SP
LÍNH	L Í NH SP
LÍP	L Í P SP
LÍT	L Í T SP
LÍU	L ÍU SP
LÒ	L Ò SP
LÒA	L ÒA SP
LÒI	L ÒI SP
LÒM	L Ò M SP
LÒNG	L Ò NG SP
LÓC	L Ó C SP
LÓE	L ÓE SP
LÓM	L Ó M SP
LÓNG	L Ó NG SP
LÓT	L Ó T SP
LÔ	L Ô SP
LÔI	L ÔI SP
LÔM	L Ô M SP
LÔNG	L Ô NG SP
LÕI	L ÕI SP
LÕM	L Õ M SP
LÕNG	L Õ NG SP
LÙ	L Ù SP
LÙA	L ÙA SP
LÙI	L ÙI SP
LÙM	L Ù M SP
LÙNG	L Ù NG SP
LÚ	L Ú SP
LÚA	L ÚA SP
LÚC	L Ú C SP
LÚI	L ÚI SP
LÚM	L Ú M SP
LÚN	L Ú N SP
LÚNG	L Ú NG SP
LÝ	L Ý SP
LĂM	L Ă M SP
LĂN	L Ă N SP
LĂNG	L Ă NG SP
LĨNH	L Ĩ NH SP
LŨ	L Ũ SP
LŨI	L ŨI SP
LŨM	L Ũ M SP
LŨN	L Ũ N SP
LŨNG	L Ũ NG SP
LŨY	L ŨY SP
LƠ	L Ơ SP
LƠI	L ƠI SP
LƠN	L Ơ N SP
LƯ	L Ư SP
LƯNG	L Ư NG SP
LƯU	L ƯU SP
LƯƠM	L ƯƠ M SP
LƯƠN	L ƯƠ N SP
LƯƠNG	L ƯƠ NG SP
LƯỚI	L ƯỚI SP
LƯỚNG	L ƯỚ NG SP
LƯỚT	L ƯỚ T SP
LƯỜI	L ƯỜI SP
LƯỜNG	L ƯỜ NG SP
LƯỠI	L ƯỠI SP
LƯỠNG	L ƯỠ NG SP
LƯỢC	L ƯỢ C SP
LƯỢM	L ƯỢ M SP
LƯỢN	L ƯỢ N SP
LƯỢNG	L ƯỢ NG SP
LƯỢT	L ƯỢ T SP
LẠ	L Ạ SP
LẠC	L Ạ C SP
LẠCH	L Ạ CH SP
LẠI	L ẠI SP
LẠM	L Ạ M SP
LẠN	L Ạ N SP
LẠNG	L Ạ NG SP
LẠNH	L Ạ NH SP
LẠO	L ẠO SP
LẠP	L Ạ P SP
LẠT	L Ạ T SP
LẠY	L ẠY SP
LẢ	L Ả SP
LẢI	L ẢI SP
LẢM	L Ả M SP
LẢNG	L Ả NG SP
LẢNH	L Ả NH SP
LẤM	L Ấ M SP
LẤN	L Ấ N SP
LẤP	L Ấ P SP
LẤT	L Ấ T SP
LẤY	L ẤY SP
LẦM	L Ầ M SP
LẦN	L Ầ N SP
LẦU	L ẦU SP
LẦY	L ẦY SP
LẨM	L Ẩ M SP
LẨN	L Ẩ N SP
LẨU	L ẨU SP
LẪN	L Ẫ N SP
LẪY	L ẪY SP
LẬN	L Ậ N SP
LẬP	L Ậ P SP
LẬT	L Ậ T SP
LẬU	L ẬU SP
LẮC	L Ắ C SP
LẮM	L Ắ M SP
LẮNG	L Ắ NG SP
LẮP	L Ắ P SP
LẮT	L Ắ T SP
LẰN	L Ằ N SP
LẰNG	L Ằ NG SP
LẲM	L Ẳ M SP
LẲN	L Ẳ N SP
LẲNG	L Ẳ NG SP
LẶM	L Ặ M SP
LẶN	L Ặ N SP
LẶNG	L Ặ NG SP
LẶP	L Ặ P SP
LẶT	L Ặ T SP
LẸ	L Ẹ SP
LẸM	L Ẹ M SP
LẺ	L Ẻ SP
LẺN	L Ẻ N SP
LẺNG	L Ẻ NG SP
LẼ	L Ẽ SP
LẼN	L Ẽ N SP
LẼO	L ẼO SP
LẾT	L Ế T SP
LẾU	L ẾU SP
LỀ	L Ề SP
LỀNH	L Ề NH SP
LỀU	L ỀU SP
LỂ	L Ể SP
LỄ	L Ễ SP
LỆ	L Ệ SP
LỆCH	L Ệ CH SP
LỆNH	L Ệ NH SP
LỈNH	L Ỉ NH SP
LỊA	L ỊA SP
LỊCH	L Ị CH SP
LỊM	L Ị M SP
LỊNH	L Ị NH SP
LỌ	L Ọ SP
LỌC	L Ọ C SP
LỌNG	L Ọ NG SP
LỌT	L Ọ T SP
LỎI	L ỎI SP
LỎN	L Ỏ N SP
LỎNG	L Ỏ NG SP
LỐ	L Ố SP
LỐC	L Ố C SP
LỐI	L ỐI SP
LỐM	L Ố M SP
LỐP	L Ố P SP
LỐT	L Ố T SP
LỒ	L Ồ SP
LỒI	L ỒI SP
LỒM	L Ồ M SP
LỒNG	L Ồ NG SP
LỔM	L Ổ M SP
LỔNG	L Ổ NG SP
LỖ	L Ỗ SP
LỖI	L ỖI SP
LỘ	L Ộ SP
LỘC	L Ộ C SP
LỘI	L ỘI SP
LỘN	L Ộ N SP
LỘNG	L Ộ NG SP
LỘP	L Ộ P SP
LỘT	L Ộ T SP
LỚN	L Ớ N SP
LỚP	L Ớ P SP
LỚT	L Ớ T SP
LỜ	L Ờ SP
LỜI	L ỜI SP
LỜM	L Ờ M SP
LỜN	L Ờ N SP
LỞ	L Ở SP
LỞI	L ỞI SP
LỞN	L Ở N SP
LỠ	L Ỡ SP
LỠM	L Ỡ M SP
LỢI	L ỢI SP
LỢM	L Ợ M SP
LỢN	L Ợ N SP
LỢP	L Ợ P SP
LỤ	L Ụ SP
LỤA	L ỤA SP
LỤC	L Ụ C SP
LỤNG	L Ụ NG SP
LỤT	L Ụ T SP
LỦ	L Ủ SP
LỦI	L ỦI SP
LỦM	L Ủ M SP
LỦNG	L Ủ NG SP
LỨA	L ỨA SP
LỨC	L Ứ C SP
LỨT	L Ứ T SP
LỪ	L Ừ SP
LỪA	L ỪA SP
LỪNG	L Ừ NG SP
LỬ	L Ử SP
LỬA	L ỬA SP
LỬNG	L Ử NG SP
LỮ	L Ữ SP
LỮA	L ỮA SP
LỮNG	L Ữ NG SP
LỰA	L ỰA SP
LỰC	L Ự C SP
LỰU	L ỰU SP
LỴ	L Ỵ SP
M	M  SP
MA	M A SP
MAI	M AI SP
MAN	M A N SP
MANG	M A NG SP
MANH	M A NH SP
MAU	M AU SP
MAY	M AY SP
ME	M E SP
MEN	M E N SP
MI	M I SP
MIN	M I N SP
MINH	M I NH SP
MIÊN	M IÊ N SP
MIÊU	M IÊU SP
MIẾNG	M IẾ NG SP
MIẾT	M IẾ T SP
MIẾU	M IẾU SP
MIỀN	M IỀ N SP
MIỀU	M IỀU SP
MIỄN	M IỄ N SP
MIỆN	M IỆ N SP
MIỆNG	M IỆ NG SP
MIỆT	M IỆ T SP
MO	M O SP
MONG	M O NG SP
MU	M U SP
MUA	M UA SP
MUN	M U N SP
MUÔN	M UÔ N SP
MUÔNG	M UÔ NG SP
MUỐI	M UỐI SP
MUỐN	M UỐ N SP
MUỐNG	M UỐ NG SP
MUỐT	M UỐ T SP
MUỒI	M UỒI SP
MUỖI	M UỖI SP
MUỖM	M UỖ M SP
MUỖNG	M UỖ NG SP
MUỘN	M UỘ N SP
MY	M Y SP
MÀ	M À SP
MÀI	M ÀI SP
MÀN	M À N SP
MÀNG	M À NG SP
MÀNH	M À NH SP
MÀO	M ÀO SP
MÀU	M ÀU SP
MÀY	M ÀY SP
MÁ	M Á SP
MÁC	M Á C SP
MÁCH	M Á CH SP
MÁI	M ÁI SP
MÁN	M Á N SP
MÁNG	M Á NG SP
MÁNH	M Á NH SP
MÁO	M ÁO SP
MÁT	M Á T SP
MÁU	M ÁU SP
MÁY	M ÁY SP
MÂM	M Â M SP
MÂN	M Â N SP
MÂU	M ÂU SP
MÂY	M ÂY SP
MÃ	M Ã SP
MÃI	M ÃI SP
MÃN	M Ã N SP
MÃNG	M Ã NG SP
MÃNH	M Ã NH SP
MÈ	M È SP
MÈN	M È N SP
MÈO	M ÈO SP
MÉ	M É SP
MÉM	M É M SP
MÉN	M É N SP
MÉO	M ÉO SP
MÉP	M É P SP
MÉT	M É T SP
MÊ	M Ê SP
MÊNH	M Ê NH SP
MÌ	M Ì SP
MÌN	M Ì N SP
MÌNH	M Ì NH SP
MÍ	M Í SP
MÍA	M ÍA SP
MÍP	M Í P SP
MÍT	M Í T SP
MÍU	M ÍU SP
MÒ	M Ò SP
MÒI	M ÒI SP
MÒN	M Ò N SP
MÒNG	M Ò NG SP
MÓ	M Ó SP
MÓC	M Ó C SP
MÓI	M ÓI SP
MÓM	M Ó M SP
MÓN	M Ó N SP
MÓNG	M Ó NG SP
MÓP	M Ó P SP
MÓT	M Ó T SP
MÔ	M Ô SP
MÔI	M ÔI SP
MÔN	M Ô N SP
MÔNG	M Ô NG SP
MÕ	M Õ SP
MÕM	M Õ M SP
MÙ	M Ù SP
MÙA	M ÙA SP
MÙI	M ÙI SP
MÙN	M Ù N SP
MÙNG	M Ù NG SP
MÚ	M Ú SP
MÚA	M ÚA SP
MÚI	M ÚI SP
MÚN	M Ú N SP
MÚP	M Ú P SP
MÚT	M Ú T SP
MĂM	M Ă M SP
MĂN	M Ă N SP
MĂNG	M Ă NG SP
MĨM	M Ĩ M SP
MŨ	M Ũ SP
MŨI	M ŨI SP
MŨM	M Ũ M SP
MƠ	M Ơ SP
MƠN	M Ơ N SP
MƯA	M ƯA SP
MƯU	M ƯU SP
MƯƠI	M ƯƠI SP
MƯƠNG	M ƯƠ NG SP
MƯỚN	M ƯỚ N SP
MƯỚP	M ƯỚ P SP
MƯỚT	M ƯỚ T SP
MƯỜI	M ƯỜI SP
MƯỜNG	M ƯỜ NG SP
MƯỢN	M ƯỢ N SP
MƯỢT	M ƯỢ T SP
MẠ	M Ạ SP
MẠC	M Ạ C SP
MẠCH	M Ạ CH SP
MẠI	M ẠI SP
MẠN	M Ạ N SP
MẠNG	M Ạ NG SP
MẠNH	M Ạ NH SP
MẠO	M ẠO SP
MẠP	M Ạ P SP
MẠT	M Ạ T SP
MẠY	M ẠY SP
MẢ	M Ả SP
MẢI	M ẢI SP
MẢNG	M Ả NG SP
MẢNH	M Ả NH SP
MẤN	M Ấ N SP
MẤT	M Ấ T SP
MẤU	M ẤU SP
MẤY	M ẤY SP
MẦM	M Ầ M SP
MẦN	M Ầ N SP
MẦU	M ẦU SP
MẨN	M Ẩ N SP
MẨU	M ẨU SP
MẨY	M ẨY SP
MẪN	M Ẫ N SP
MẪU	M ẪU SP
MẬN	M Ậ N SP
MẬP	M Ậ P SP
MẬT	M Ậ T SP
MẬU	M ẬU SP
MẮC	M Ắ C SP
MẮM	M Ắ M SP
MẮN	M Ắ N SP
MẮNG	M Ắ NG SP
MẮT	M Ắ T SP
MẰN	M Ằ N SP
MẲN	M Ẳ N SP
MẶC	M Ặ C SP
MẶN	M Ặ N SP
MẶT	M Ặ T SP
MẸ	M Ẹ SP
MẸO	M ẸO SP
MẸT	M Ẹ T SP
MẺ	M Ẻ SP
MẼ	M Ẽ SP
MẾCH	M Ế CH SP
MẾN	M Ế N SP
MẾU	M ẾU SP
MỀ	M Ề SP
MỀM	M Ề M SP
MỀN	M Ề N SP
MỆ	M Ệ SP
MỆNH	M Ệ NH SP
MỆT	M Ệ T SP
MỈ	M Ỉ SP
MỈA	M ỈA SP
MỈM	M Ỉ M SP
MỊ	M Ị SP
MỊN	M Ị N SP
MỊT	M Ị T SP
MỌ	M Ọ SP
MỌC	M Ọ C SP
MỌI	M ỌI SP
MỌN	M Ọ N SP
MỌNG	M Ọ NG SP
MỌT	M Ọ T SP
MỎ	M Ỏ SP
MỎI	M ỎI SP
MỎM	M Ỏ M SP
MỎNG	M Ỏ NG SP
MỐC	M Ố C SP
MỐI	M ỐI SP
MỐT	M Ố T SP
MỒ	M Ồ SP
MỒI	M ỒI SP
MỒM	M Ồ M SP
MỒNG	M Ồ NG SP
MỔ	M Ổ SP
MỖ	M Ỗ SP
MỖI	M ỖI SP
MỘ	M Ộ SP
MỘC	M Ộ C SP
MỘNG	M Ộ NG SP
MỘT	M Ộ T SP
MỚ	M Ớ SP
MỚI	M ỚI SP
MỚP	M Ớ P SP
MỜ	M Ờ SP
MỜI	M ỜI SP
MỞ	M Ở SP
MỞN	M Ở N SP
MỠ	M Ỡ SP
MỢ	M Ợ SP
MỤ	M Ụ SP
MỤC	M Ụ C SP
MỤN	M Ụ N SP
MỤP	M Ụ P SP
MỦ	M Ủ SP
MỦI	M ỦI SP
MỦN	M Ủ N SP
MỨC	M Ứ C SP
MỨT	M Ứ T SP
MỪNG	M Ừ NG SP
MỬA	M ỬA SP
MỰC	M Ự C SP
MỸ	M Ỹ SP
NA	N A SP
NAI	N AI SP
NAM	N A M SP
NAN	N A N SP
NANG	N A NG SP
NANH	N A NH SP
NAO	N AO SP
NAY	N AY SP
NEM	N E M SP
NEO	N EO SP
NGA	NG A SP
NGAI	NG AI SP
NGAN	NG A N SP
NGANG	NG A NG SP
NGAO	NG AO SP
NGAY	NG AY SP
NGHE	NGH E SP
NGHI	NGH I SP
NGHIÊM	NGH IÊ M SP
NGHIÊN	NGH IÊ N SP
NGHIÊNG	NGH IÊ NG SP
NGHIẾN	NGH IẾ N SP
NGHIỀN	NGH IỀ N SP
NGHIỆM	NGH IỆ M SP
NGHIỆN	NGH IỆ N SP
NGHIỆP	NGH IỆ P SP
NGHIỆT	NGH IỆ T SP
NGHÈ	NGH È SP
NGHÈO	NGH ÈO SP
NGHÉ	NGH É SP
NGHÊ	NGH Ê SP
NGHÊNH	NGH Ê NH SP
NGHÊU	NGH ÊU SP
NGHÌN	NGH Ì N SP
NGHĨ	NGH Ĩ SP
NGHĨA	NGH ĨA SP
NGHĨNH	NGH Ĩ NH SP
NGHẸN	NGH Ẹ N SP
NGHẸO	NGH ẸO SP
NGHẸT	NGH Ẹ T SP
NGHẺO	NGH ẺO SP
NGHẼN	NGH Ẽ N SP
NGHẾCH	NGH Ế CH SP
NGHỀ	NGH Ề SP
NGHỆ	NGH Ệ SP
NGHỈ	NGH Ỉ SP
NGHỈU	NGH ỈU SP
NGHỊ	NGH Ị SP
NGHỊCH	NGH Ị CH SP
NGOA	NG OA SP
NGOAN	NG OA N SP
NGOANG	NG OA NG SP
NGOAY	NG OAY SP
NGOE	NG OE SP
NGOI	NG OI SP
NGON	NG O N SP
NGOÀI	NG OÀI SP
NGOÀM	NG OÀ M SP
NGOÁC	NG OÁ C SP
NGOÁCH	NG OÁ CH SP
NGOÁI	NG OÁI SP
NGOÁO	NG OÁO SP
NGOÁY	NG OÁY SP
NGOÃN	NG OÃ N SP
NGOÈO	NG OÈO SP
NGOÉO	NG OÉO SP
NGOẠI	NG OẠI SP
NGOẠN	NG OẠ N SP
NGOẢNH	NG OẢ NH SP
NGOẮC	NG OẮ C SP
NGOẮT	NG OẮ T SP
NGOẰN	NG OẰ N SP
NGOẰNG	NG OẰ NG SP
NGOẴNG	NG OẴ NG SP
NGOẶC	NG OẶ C SP
NGOẶT	NG OẶ T SP
NGU	NG U SP
NGUY	NG UY SP
NGUYÊN	NG UYÊ N SP
NGUYỀN	NG UYỀ N SP
NGUYỄN	NG UYỄ N SP
NGUYỆN	NG UYỆ N SP
NGUYỆT	NG UYỆ T SP
NGUẨY	NG UẨY SP
NGUỒI	NG UỒI SP
NGUỒN	NG UỒ N SP
NGUỘI	NG UỘI SP
NGÀ	NG À SP
NGÀI	NG ÀI SP
NGÀM	NG À M SP
NGÀN	NG À N SP
NGÀNG	NG À NG SP
NGÀNH	NG À NH SP
NGÀO	NG ÀO SP
NGÀY	NG ÀY SP
NGÁCH	NG Á CH SP
NGÁN	NG Á N SP
NGÁNG	NG Á NG SP
NGÁO	NG ÁO SP
NGÁP	NG Á P SP
NGÁT	NG Á T SP
NGÁU	NG ÁU SP
NGÁY	NG ÁY SP
NGÂM	NG Â M SP
NGÂN	NG Â N SP
NGÂY	NG ÂY SP
NGÃ	NG Ã SP
NGÃI	NG ÃI SP
NGÍA	NG ÍA SP
NGÒ	NG Ò SP
NGÒI	NG ÒI SP
NGÓ	NG Ó SP
NGÓC	NG Ó C SP
NGÓE	NG ÓE SP
NGÓI	NG ÓI SP
NGÓN	NG Ó N SP
NGÓNG	NG Ó NG SP
NGÓT	NG Ó T SP
NGÔ	NG Ô SP
NGÔI	NG ÔI SP
NGÔN	NG Ô N SP
NGÔNG	NG Ô NG SP
NGÕ	NG Õ SP
NGÙI	NG ÙI SP
NGÚC	NG Ú C SP
NGÚNG	NG Ú NG SP
NGÚT	NG Ú T SP
NGĂN	NG Ă N SP
NGŨ	NG Ũ SP
NGƠ	NG Ơ SP
NGƠI	NG ƠI SP
NGƯ	NG Ư SP
NGƯA	NG ƯA SP
NGƯNG	NG Ư NG SP
NGƯU	NG ƯU SP
NGƯƠI	NG ƯƠI SP
NGƯỚC	NG ƯỚ C SP
NGƯỜI	NG ƯỜI SP
NGƯỞNG	NG ƯỞ NG SP
NGƯỠNG	NG ƯỠ NG SP
NGƯỢC	NG ƯỢ C SP
NGƯỢNG	NG ƯỢ NG SP
NGẠC	NG Ạ C SP
NGẠI	NG ẠI SP
NGẠN	NG Ạ N SP
NGẠO	NG ẠO SP
NGẠT	NG Ạ T SP
NGẢ	NG Ả SP
NGẢI	NG ẢI SP
NGẢNH	NG Ả NH SP
NGẤT	NG Ấ T SP
NGẤU	NG ẤU SP
NGẤY	NG ẤY SP
NGẦM	NG Ầ M SP
NGẦN	NG Ầ N SP
NGẦY	NG ẦY SP
NGẨM	NG Ẩ M SP
NGẨN	NG Ẩ N SP
NGẨNG	NG Ẩ NG SP
NGẪM	NG Ẫ M SP
NGẪU	NG ẪU SP
NGẬM	NG Ậ M SP
NGẬP	NG Ậ P SP
NGẬU	NG ẬU SP
NGẬY	NG ẬY SP
NGẮC	NG Ắ C SP
NGẮM	NG Ắ M SP
NGẮN	NG Ắ N SP
NGẮT	NG Ắ T SP
NGẴNG	NG Ẵ NG SP
NGẶT	NG Ặ T SP
NGỌ	NG Ọ SP
NGỌC	NG Ọ C SP
NGỌN	NG Ọ N SP
NGỌNG	NG Ọ NG SP
NGỌT	NG Ọ T SP
NGỎ	NG Ỏ SP
NGỐC	NG Ố C SP
NGỒI	NG ỒI SP
NGỒM	NG Ồ M SP
NGỒN	NG Ồ N SP
NGỔ	NG Ổ SP
NGỔM	NG Ổ M SP
NGỖ	NG Ỗ SP
NGỘ	NG Ộ SP
NGỘN	NG Ộ N SP
NGỘT	NG Ộ T SP
NGỚN	NG Ớ N SP
NGỚT	NG Ớ T SP
NGỜ	NG Ờ SP
NGỠ	NG Ỡ SP
NGỢ	NG Ợ SP
NGỢI	NG ỢI SP
NGỢM	NG Ợ M SP
NGỢP	NG Ợ P SP
NGỤ	NG Ụ SP
NGỤA	NG ỤA SP
NGỤC	NG Ụ C SP
NGỤM	NG Ụ M SP
NGỤP	NG Ụ P SP
NGỦ	NG Ủ SP
NGỦI	NG ỦI SP
NGỦN	NG Ủ N SP
NGỨ	NG Ứ SP
NGỨA	NG ỨA SP
NGỪA	NG ỪA SP
NGỪNG	NG Ừ NG SP
NGỬI	NG ỬI SP
NGỬNG	NG Ử NG SP
NGỮ	NG Ữ SP
NGỰ	NG Ự SP
NGỰA	NG ỰA SP
NGỰC	NG Ự C SP
NHA	NH A SP
NHAI	NH AI SP
NHAM	NH A M SP
NHAN	NH A N SP
NHANG	NH A NG SP
NHANH	NH A NH SP
NHAO	NH AO SP
NHAU	NH AU SP
NHAY	NH AY SP
NHE	NH E SP
NHEM	NH E M SP
NHEN	NH E N SP
NHEO	NH EO SP
NHI	NH I SP
NHIÊN	NH IÊ N SP
NHIÊU	NH IÊU SP
NHIẾC	NH IẾ C SP
NHIẾP	NH IẾ P SP
NHIỀU	NH IỀU SP
NHIỄM	NH IỄ M SP
NHIỄU	NH IỄU SP
NHIỆM	NH IỆ M SP
NHIỆT	NH IỆ T SP
NHO	NH O SP
NHOAI	NH OAI SP
NHOE	NH OE SP
NHOEN	NH OE N SP
NHOM	NH O M SP
NHONG	NH O NG SP
NHOÀI	NH OÀI SP
NHOÁNG	NH OÁ NG SP
NHOÉT	NH OÉ T SP
NHOẺN	NH OẺ N SP
NHU	NH U SP
NHUNG	NH U NG SP
NHUYỄN	NH UYỄ N SP
NHUẦN	NH UẦ N SP
NHUẬN	NH UẬ N SP
NHUỆ	NH UỆ SP
NHUỐM	NH UỐ M SP
NHUỘM	NH UỘ M SP
NHÀ	NH À SP
NHÀI	NH ÀI SP
NHÀM	NH À M SP
NHÀN	NH À N SP
NHÀNG	NH À NG SP
NHÀNH	NH À NH SP
NHÀO	NH ÀO SP
NHÀU	NH ÀU SP
NHÁ	NH Á SP
NHÁC	NH Á C SP
NHÁNG	NH Á NG SP
NHÁNH	NH Á NH SP
NHÁO	NH ÁO SP
NHÁT	NH Á T SP
NHÁY	NH ÁY SP
NHÂM	NH Â M SP
NHÂN	NH Â N SP
NHÃ	NH Ã SP
NHÃI	NH ÃI SP
NHÃN	NH Ã N SP
NHÃO	NH ÃO SP
NHÈ	NH È SP
NHÈM	NH È M SP
NHÉ	NH É SP
NHÉP	NH É P SP
NHÉT	NH É T SP
NHÌ	NH Ì SP
NHÌN	NH Ì N SP
NHÍ	NH Í SP
NHÍCH	NH Í CH SP
NHÍM	NH Í M SP
NHÍT	NH Í T SP
NHÍU	NH ÍU SP
NHÒE	NH ÒE SP
NHÒM	NH Ò M SP
NHÓC	NH Ó C SP
NHÓI	NH ÓI SP
NHÓM	NH Ó M SP
NHÓNG	NH Ó NG SP
NHÓP	NH Ó P SP
NHÓT	NH Ó T SP
NHÔ	NH Ô SP
NHÔM	NH Ô M SP
NHÔN	NH Ô N SP
NHÔNG	NH Ô NG SP
NHÕ	NH Õ SP
NHÕM	NH Õ M SP
NHÕN	NH Õ N SP
NHÕNG	NH Õ NG SP
NHÙ	NH Ù SP
NHÙI	NH ÙI SP
NHÙNG	NH Ù NG SP
NHÚ	NH Ú SP
NHÚA	NH ÚA SP
NHÚC	NH Ú C SP
NHÚN	NH Ú N SP
NHÚNG	NH Ú NG SP
NHÚT	NH Ú T SP
NHĂM	NH Ă M SP
NHĂN	NH Ă N SP
NHĂNG	NH Ă NG SP
NHĨ	NH Ĩ SP
NHŨ	NH Ũ SP
NHŨNG	NH Ũ NG SP
NHƠI	NH ƠI SP
NHƠN	NH Ơ N SP
NHƯ	NH Ư SP
NHƯNG	NH Ư NG SP
NHƯỚNG	NH ƯỚ NG SP
NHƯỜNG	NH ƯỜ NG SP
NHƯỠNG	NH ƯỠ NG SP
NHƯỢC	NH ƯỢ C SP
NHƯỢNG	NH ƯỢ NG SP
NHẠC	NH Ạ C SP
NHẠI	NH ẠI SP
NHẠNH	NH Ạ NH SP
NHẠO	NH ẠO SP
NHẠT	NH Ạ T SP
NHẠY	NH ẠY SP
NHẢ	NH Ả SP
NHẢI	NH ẢI SP
NHẢM	NH Ả M SP
NHẢNH	NH Ả NH SP
NHẢY	NH ẢY SP
NHẤC	NH Ấ C SP
NHẤM	NH Ấ M SP
NHẤN	NH Ấ N SP
NHẤP	NH Ấ P SP
NHẤT	NH Ấ T SP
NHẦM	NH Ầ M SP
NHẦY	NH ẦY SP
NHẨM	NH Ẩ M SP
NHẪN	NH Ẫ N SP
NHẪY	NH ẪY SP
NHẬM	NH Ậ M SP
NHẬN	NH Ậ N SP
NHẬP	NH Ậ P SP
NHẬT	NH Ậ T SP
NHẬU	NH ẬU SP
NHẮC	NH Ắ C SP
NHẮM	NH Ắ M SP
NHẮN	NH Ắ N SP
NHẮT	NH Ắ T SP
NHẰM	NH Ằ M SP
NHẰN	NH Ằ N SP
NHẰNG	NH Ằ NG SP
NHẴN	NH Ẵ N SP
NHẶM	NH Ặ M SP
NHẶNG	NH Ặ NG SP
NHẶT	NH Ặ T SP
NHẸ	NH Ẹ SP
NHẸM	NH Ẹ M SP
NHẸP	NH Ẹ P SP
NHẺM	NH Ẻ M SP
NHẼO	NH ẼO SP
NHẾCH	NH Ế CH SP
NHỆN	NH Ệ N SP
NHỆU	NH ỆU SP
NHỈ	NH Ỉ SP
NHỈNH	NH Ỉ NH SP
NHỊ	NH Ị SP
NHỊN	NH Ị N SP
NHỊP	NH Ị P SP
NHỌC	NH Ọ C SP
NHỌN	NH Ọ N SP
NHỌT	NH Ọ T SP
NHỎ	NH Ỏ SP
NHỎM	NH Ỏ M SP
NHỐ	NH Ố SP
NHỐI	NH ỐI SP
NHỐT	NH Ố T SP
NHỒI	NH ỒI SP
NHỒN	NH Ồ N SP
NHỔM	NH Ổ M SP
NHỔN	NH Ổ N SP
NHỘN	NH Ộ N SP
NHỘT	NH Ộ T SP
NHỚ	NH Ớ SP
NHỚP	NH Ớ P SP
NHỜ	NH Ờ SP
NHỜN	NH Ờ N SP
NHỞ	NH Ở SP
NHỢT	NH Ợ T SP
NHỤA	NH ỤA SP
NHỤC	NH Ụ C SP
NHỤY	NH ỤY SP
NHỦ	NH Ủ SP
NHỦN	NH Ủ N SP
NHỨ	NH Ứ SP
NHỨC	NH Ứ C SP
NHỮNG	NH Ữ NG SP
NHỰA	NH ỰA SP
NHỰT	NH Ự T SP
NI	N I SP
NIA	N IA SP
NIN	N I N SP
NINH	N I NH SP
NIU	N IU SP
NIÊM	N IÊ M SP
NIÊN	N IÊ N SP
NIÊU	N IÊU SP
NIẾT	N IẾ T SP
NIỀM	N IỀ M SP
NIỀNG	N IỀ NG SP
NIỆM	N IỆ M SP
NIỆU	N IỆU SP
NO	N O SP
NOM	N O M SP
NON	N O N SP
NONG	N O NG SP
NUA	N UA SP
NUNG	N U NG SP
NUÔI	N UÔI SP
NUÔNG	N UÔ NG SP
NUỐI	N UỐI SP
NUỐT	N UỐ T SP
NÀ	N À SP
NÀN	N À N SP
NÀNG	N À NG SP
NÀNH	N À NH SP
NÀO	N ÀO SP
NÀY	N ÀY SP
NÁ	N Á SP
NÁCH	N Á CH SP
NÁM	N Á M SP
NÁN	N Á N SP
NÁO	N ÁO SP
NÁT	N Á T SP
NÁU	N ÁU SP
NÁY	N ÁY SP
NÂNG	N Â NG SP
NÂU	N ÂU SP
NÂY	N ÂY SP
NÃO	N ÃO SP
NÃY	N ÃY SP
NÈ	N È SP
NÈO	N ÈO SP
NÉ	N É SP
NÉM	N É M SP
NÉN	N É N SP
NÉO	N ÉO SP
NÉP	N É P SP
NÉT	N É T SP
NÊ	N Ê SP
NÊM	N Ê M SP
NÊN	N Ê N SP
NÊU	N ÊU SP
NÌ	N Ì SP
NÌNH	N Ì NH SP
NÍCH	N Í CH SP
NÍN	N Í N SP
NÍNH	N Í NH SP
NÍT	N Í T SP
NÍU	N ÍU SP
NÓ	N Ó SP
NÓC	N Ó C SP
NÓI	N ÓI SP
NÓN	N Ó N SP
NÓNG	N Ó NG SP
NÓT	N Ó T SP
NÔ	N Ô SP
NÔI	N ÔI SP
NÔM	N Ô M SP
NÔN	N Ô N SP
NÔNG	N Ô NG SP
NÕN	N Õ N SP
NÙN	N Ù N SP
NÙNG	N Ù NG SP
NÚC	N Ú C SP
NÚI	N ÚI SP
NÚM	N Ú M SP
NÚNG	N Ú NG SP
NÚP	N Ú P SP
NÚT	N Ú T SP
NĂM	N Ă M SP
NĂN	N Ă N SP
NĂNG	N Ă NG SP
NĨA	N ĨA SP
NŨNG	N Ũ NG SP
NƠI	N ƠI SP
NƠM	N Ơ M SP
NƯ	N Ư SP
NƯƠNG	N ƯƠ NG SP
NƯỚC	N ƯỚ C SP
NƯỚNG	N ƯỚ NG SP
NẠ	N Ạ SP
NẠC	N Ạ C SP
NẠI	N ẠI SP
NẠN	N Ạ N SP
NẠNH	N Ạ NH SP
NẠO	N ẠO SP
NẠP	N Ạ P SP
NẠT	N Ạ T SP
NẢ	N Ả SP
NẢN	N Ả N SP
NẢY	N ẢY SP
NẤC	N Ấ C SP
NẤM	N Ấ M SP
NẤNG	N Ấ NG SP
NẤU	N ẤU SP
NẤY	N ẤY SP
NẦN	N Ầ N SP
NẦY	N ẦY SP
NẬM	N Ậ M SP
NẬP	N Ậ P SP
NẬU	N ẬU SP
NẮC	N Ắ C SP
NẮM	N Ắ M SP
NẮN	N Ắ N SP
NẮNG	N Ắ NG SP
NẮP	N Ắ P SP
NẰM	N Ằ M SP
NẰN	N Ằ N SP
NẰNG	N Ằ NG SP
NẴNG	N Ẵ NG SP
NẶC	N Ặ C SP
NẶNG	N Ặ NG SP
NẸP	N Ẹ P SP
NẺ	N Ẻ SP
NẺO	N ẺO SP
NẾM	N Ế M SP
NẾN	N Ế N SP
NẾP	N Ế P SP
NẾT	N Ế T SP
NẾU	N ẾU SP
NỀ	N Ề SP
NỀN	N Ề N SP
NỂ	N Ể SP
NỆ	N Ệ SP
NỆM	N Ệ M SP
NỈ	N Ỉ SP
NỊCH	N Ị CH SP
NỊNH	N Ị NH SP
NỊU	N ỊU SP
NỌ	N Ọ SP
NỌC	N Ọ C SP
NỌNG	N Ọ NG SP
NỌT	N Ọ T SP
NỎ	N Ỏ SP
NỐ	N Ố SP
NỐC	N Ố C SP
NỐI	N ỐI SP
NỐNG	N Ố NG SP
NỐT	N Ố T SP
NỒ	N Ồ SP
NỒI	N ỒI SP
NỒM	N Ồ M SP
NỒNG	N Ồ NG SP
NỔ	N Ổ SP
NỔI	N ỔI SP
NỖ	N Ỗ SP
NỖI	N ỖI SP
NỘ	N Ộ SP
NỘC	N Ộ C SP
NỘI	N ỘI SP
NỘN	N Ộ N SP
NỘP	N Ộ P SP
NỚ	N Ớ SP
NỚI	N ỚI SP
NỚP	N Ớ P SP
NỚT	N Ớ T SP
NỞ	N Ở SP
NỠ	N Ỡ SP
NỢ	N Ợ SP
NỤ	N Ụ SP
NỨC	N Ứ C SP
NỨT	N Ứ T SP
NỬA	N ỬA SP
NỮ	N Ữ SP
NỮA	N ỮA SP
NỰ	N Ự SP
NỰC	N Ự C SP
O	O SP
OAI	OAI SP
OAN	OA N SP
OANH	OA NH SP
OE	OE SP
OI	OI SP
OM	O M SP
ONG	O NG SP
OÀNH	OÀ NH SP
OÁCH	OÁ CH SP
OÁI	OÁI SP
OÁN	OÁ N SP
OĂM	OĂ M SP
OẠP	OẠ P SP
OẢI	OẢI SP
OẮT	OẮ T SP
OẰN	OẰ N SP
PA	P A SP
PHA	PH A SP
PHAN	PH A N SP
PHANH	PH A NH SP
PHAO	PH AO SP
PHE	PH E SP
PHI	PH I SP
PHIM	PH I M SP
PHIÊN	PH IÊ N SP
PHIÊU	PH IÊU SP
PHIẾM	PH IẾ M SP
PHIẾT	PH IẾ T SP
PHIẾU	PH IẾU SP
PHIỀN	PH IỀ N SP
PHIỆN	PH IỆ N SP
PHO	PH O SP
PHONG	PH O NG SP
PHU	PH U SP
PHUN	PH U N SP
PHUNG	PH U NG SP
PHUY	PH UY SP
PHÀM	PH À M SP
PHÀN	PH À N SP
PHÀO	PH ÀO SP
PHÁ	PH Á SP
PHÁC	PH Á C SP
PHÁCH	PH Á CH SP
PHÁI	PH ÁI SP
PHÁN	PH Á N SP
PHÁO	PH ÁO SP
PHÁP	PH Á P SP
PHÁT	PH Á T SP
PHÂN	PH Â N SP
PHÂY	PH ÂY SP
PHÈ	PH È SP
PHÈN	PH È N SP
PHÈO	PH ÈO SP
PHÉNG	PH É NG SP
PHÉP	PH É P SP
PHÉT	PH É T SP
PHÊ	PH Ê SP
PHÌ	PH Ì SP
PHÌNH	PH Ì NH SP
PHÍ	PH Í SP
PHÍA	PH ÍA SP
PHÍCH	PH Í CH SP
PHÍM	PH Í M SP
PHÍNH	PH Í NH SP
PHÒ	PH Ò SP
PHÒI	PH ÒI SP
PHÒNG	PH Ò NG SP
PHÓ	PH Ó SP
PHÓC	PH Ó C SP
PHÓNG	PH Ó NG SP
PHÓT	PH Ó T SP
PHÔ	PH Ô SP
PHÙ	PH Ù SP
PHÙNG	PH Ù NG SP
PHÚ	PH Ú SP
PHÚC	PH Ú C SP
PHÚNG	PH Ú NG SP
PHÚT	PH Ú T SP
PHĂNG	PH Ă NG SP
PHĨNH	PH Ĩ NH SP
PHƠ	PH Ơ SP
PHƠI	PH ƠI SP
PHƠN	PH Ơ N SP
PHƯƠNG	PH ƯƠ NG SP
PHƯỚC	PH ƯỚ C SP
PHƯỚN	PH ƯỚ N SP
PHƯỜNG	PH ƯỜ NG SP
PHƯỢNG	PH ƯỢ NG SP
PHẠC	PH Ạ C SP
PHẠM	PH Ạ M SP
PHẠNG	PH Ạ NG SP
PHẠT	PH Ạ T SP
PHẢ	PH Ả SP
PHẢI	PH ẢI SP
PHẢN	PH Ả N SP
PHẢY	PH ẢY SP
PHẤN	PH Ấ N SP
PHẤT	PH Ấ T SP
PHẦM	PH Ầ M SP
PHẦN	PH Ầ N SP
PHẨM	PH Ẩ M SP
PHẨY	PH ẨY SP
PHẪN	PH Ẫ N SP
PHẪU	PH ẪU SP
PHẬN	PH Ậ N SP
PHẬT	PH Ậ T SP
PHẮC	PH Ắ C SP
PHẲNG	PH Ẳ NG SP
PHẾ	PH Ế SP
PHẾCH	PH Ế CH SP
PHẾT	PH Ế T SP
PHỀ	PH Ề SP
PHỀU	PH ỀU SP
PHỄU	PH ỄU SP
PHỆ	PH Ệ SP
PHỆNH	PH Ệ NH SP
PHỈ	PH Ỉ SP
PHỈNH	PH Ỉ NH SP
PHỊCH	PH Ị CH SP
PHỌT	PH Ọ T SP
PHỎNG	PH Ỏ NG SP
PHỐ	PH Ố SP
PHỐC	PH Ố C SP
PHỐI	PH ỐI SP
PHỒM	PH Ồ M SP
PHỒNG	PH Ồ NG SP
PHỔ	PH Ổ SP
PHỔI	PH ỔI SP
PHỔNG	PH Ổ NG SP
PHỖNG	PH Ỗ NG SP
PHỘNG	PH Ộ NG SP
PHỚI	PH ỚI SP
PHỚT	PH Ớ T SP
PHỜ	PH Ờ SP
PHỞ	PH Ở SP
PHỠN	PH Ỡ N SP
PHỤ	PH Ụ SP
PHỤC	PH Ụ C SP
PHỤNG	PH Ụ NG SP
PHỦ	PH Ủ SP
PHỦI	PH ỦI SP
PHỨC	PH Ứ C SP
PIN	P I N SP
PIÊU	P IÊU SP
PÍ	P Í SP
QUA	QU A SP
QUAI	QU AI SP
QUAN	QU A N SP
QUANG	QU A NG SP
QUANH	QU A NH SP
QUAY	QU AY SP
QUE	QU E SP
QUEN	QU E N SP
QUEO	QU EO SP
QUI	QU I SP
QUOẠNG	QU OẠ NG SP
QUY	QU Y SP
QUYÊN	QU YÊ N SP
QUYẾN	QU YẾ N SP
QUYẾT	QU YẾ T SP
QUYỀN	QU YỀ N SP
QUYỂN	QU YỂ N SP
QUYỆN	QU YỆ N SP
QUYỆT	QU YỆ T SP
QUÀ	QU À SP
QUÀI	QU ÀI SP
QUÀNG	QU À NG SP
QUÀY	QU ÀY SP
QUÁ	QU Á SP
QUÁC	QU Á C SP
QUÁCH	QU Á CH SP
QUÁI	QU ÁI SP
QUÁN	QU Á N SP
QUÁNG	QU Á NG SP
QUÁNH	QU Á NH SP
QUÁT	QU Á T SP
QUÂN	QU Â N SP
QUÂY	QU ÂY SP
QUÃNG	QU Ã NG SP
QUÈ	QU È SP
QUÈN	QU È N SP
QUÉT	QU É T SP
QUÊ	QU Ê SP
QUÊN	QU Ê N SP
QUÌ	QU Ì SP
QUÍ	QU Í SP
QUÍT	QU Í T SP
QUÝ	QU Ý SP
QUÝNH	QU Ý NH SP
QUÝT	QU Ý T SP
QUĂM	QU Ă M SP
QUĂNG	QU Ă NG SP
QUĨ	QU Ĩ SP
QUẠC	QU Ạ C SP
QUẠCH	QU Ạ CH SP
QUẠI	QU ẠI SP
QUẠNG	QU Ạ NG SP
QUẠNH	QU Ạ NH SP
QUẠT	QU Ạ T SP
QUẢ	QU Ả SP
QUẢI	QU ẢI SP
QUẢN	QU Ả N SP
QUẢNG	QU Ả NG SP
QUẢY	QU ẢY SP
QUẤN	QU Ấ N SP
QUẤT	QU Ấ T SP
QUẤY	QU ẤY SP
QUẦN	QU Ầ N SP
QUẦNG	QU Ầ NG SP
QUẦY	QU ẦY SP
QUẨN	QU Ẩ N SP
QUẪN	QU Ẫ N SP
QUẪY	QU ẪY SP
QUẬN	QU Ậ N SP
QUẬT	QU Ậ T SP
QUẬY	QU ẬY SP
QUẮC	QU Ắ C SP
QUẮN	QU Ắ N SP
QUẰN	QU Ằ N SP
QUẲNG	QU Ẳ NG SP
QUẶC	QU Ặ C SP
QUẶM	QU Ặ M SP
QUẶN	QU Ặ N SP
QUẶT	QU Ặ T SP
QUẸO	QU ẸO SP
QUẾ	QU Ế SP
QUẾT	QU Ế T SP
QUỀNH	QU Ề NH SP
QUỆ	QU Ệ SP
QUỆNH	QU Ệ NH SP
QUỈ	QU Ỉ SP
QUỊ	QU Ị SP
QUỐC	QU Ố C SP
QUỚI	QU ỚI SP
QUỜ	QU Ờ SP
QUỜN	QU Ờ N SP
QUỲ	QU Ỳ SP
QUỲNH	QU Ỳ NH SP
QUỴ	QU Ỵ SP
QUỴT	QU Ỵ T SP
QUỶ	QU Ỷ SP
QUỸ	QU Ỹ SP
RA	R A SP
RAI	R AI SP
RAM	R A M SP
RAN	R A N SP
RANG	R A NG SP
RANH	R A NH SP
RAO	R AO SP
RAU	R AU SP
RAY	R AY SP
RE	R E SP
REN	R E N SP
REO	R EO SP
RI	R I SP
RIA	R IA SP
RINH	R I NH SP
RIU	R IU SP
RIÊNG	R IÊ NG SP
RIÊU	R IÊU SP
RIẾP	R IẾ P SP
RIẾT	R IẾ T SP
RIỆT	R IỆ T SP
RO	R O SP
ROI	R OI SP
ROM	R O M SP
RONG	R O NG SP
RU	R U SP
RUA	R UA SP
RUN	R U N SP
RUNG	R U NG SP
RUỐC	R UỐ C SP
RUỒI	R UỒI SP
RUỔI	R UỔI SP
RUỖNG	R UỖ NG SP
RUỘNG	R UỘ NG SP
RUỘT	R UỘ T SP
RÀ	R À SP
RÀNG	R À NG SP
RÀNH	R À NH SP
RÀO	R ÀO SP
RÀY	R ÀY SP
RÁC	R Á C SP
RÁCH	R Á CH SP
RÁI	R ÁI SP
RÁN	R Á N SP
RÁNG	R Á NG SP
RÁO	R ÁO SP
RÁP	R Á P SP
RÁT	R Á T SP
RÁY	R ÁY SP
RÂM	R Â M SP
RÂN	R Â N SP
RÂU	R ÂU SP
RÃ	R Ã SP
RÃI	R ÃI SP
RÃY	R ÃY SP
RÈM	R È M SP
RÈN	R È N SP
RÈO	R ÈO SP
RÉN	R É N SP
RÉO	R ÉO SP
RÉT	R É T SP
RÊ	R Ê SP
RÊN	R Ê N SP
RÊU	R ÊU SP
RÌ	R Ì SP
RÌA	R ÌA SP
RÌNH	R Ì NH SP
RÍT	R Í T SP
RÍU	R ÍU SP
RÒI	R ÒI SP
RÒM	R Ò M SP
RÒNG	R Ò NG SP
RÓ	R Ó SP
RÓC	R Ó C SP
RÓI	R ÓI SP
RÓN	R Ó N SP
RÓT	R Ó T SP
RÔ	R Ô SP
RÕ	R Õ SP
RÙA	R ÙA SP
RÙM	R Ù M SP
RÚ	R Ú SP
RÚC	R Ú C SP
RÚM	R Ú M SP
RÚNG	R Ú NG SP
RÚT	R Ú T SP
RĂN	R Ă N SP
RĂNG	R Ă NG SP
RĨ	R Ĩ SP
RŨ	R Ũ SP
RƠ	R Ơ SP
RƠI	R ƠI SP
RƠM	R Ơ M SP
RƠN	R Ơ N SP
RƯNG	R Ư NG SP
RƯƠI	R ƯƠI SP
RƯỚC	R ƯỚ C SP
RƯỚI	R ƯỚI SP
RƯỚM	R ƯỚ M SP
RƯỜI	R ƯỜI SP
RƯỞI	R ƯỞI SP
RƯỠI	R ƯỠI SP
RƯỢI	R ƯỢI SP
RƯỢT	R ƯỢ T SP
RƯỢU	R ƯỢU SP
RẠ	R Ạ SP
RẠCH	R Ạ CH SP
RẠN	R Ạ N SP
RẠNG	R Ạ NG SP
RẠO	R ẠO SP
RẠP	R Ạ P SP
RẠT	R Ạ T SP
RẢ	R Ả SP
RẢI	R ẢI SP
RẢNH	R Ả NH SP
RẢO	R ẢO SP
RẤN	R Ấ N SP
RẤP	R Ấ P SP
RẤT	R Ấ T SP
RẦM	R Ầ M SP
RẦN	R Ầ N SP
RẦU	R ẦU SP
RẦY	R ẦY SP
RẨY	R ẨY SP
RẪY	R ẪY SP
RẬN	R Ậ N SP
RẬP	R Ậ P SP
RẬT	R Ậ T SP
RẮC	R Ắ C SP
RẮM	R Ắ M SP
RẮN	R Ắ N SP
RẰM	R Ằ M SP
RẰNG	R Ằ NG SP
RẶNG	R Ặ NG SP
RẸO	R ẸO SP
RẸT	R Ẹ T SP
RẺ	R Ẻ SP
RẼ	R Ẽ SP
RẾ	R Ế SP
RẾN	R Ế N SP
RẾT	R Ế T SP
RỀ	R Ề SP
RỂ	R Ể SP
RỄ	R Ễ SP
RỆ	R Ệ SP
RỆT	R Ệ T SP
RỆU	R ỆU SP
RỈ	R Ỉ SP
RỈA	R ỈA SP
RỈNH	R Ỉ NH SP
RỊA	R ỊA SP
RỊCH	R Ị CH SP
RỊN	R Ị N SP
RỊT	R Ị T SP
RỌI	R ỌI SP
RỎI	R ỎI SP
RỐC	R Ố C SP
RỐI	R ỐI SP
RỐN	R Ố N SP
RỐNG	R Ố NG SP
RỐP	R Ố P SP
RỐT	R Ố T SP
RỒ	R Ồ SP
RỒI	R ỒI SP
RỒNG	R Ồ NG SP
RỔ	R Ổ SP
RỖI	R ỖI SP
RỖNG	R Ỗ NG SP
RỘ	R Ộ SP
RỘC	R Ộ C SP
RỘN	R Ộ N SP
RỘNG	R Ộ NG SP
RỘP	R Ộ P SP
RỚM	R Ớ M SP
RỚT	R Ớ T SP
RỜ	R Ờ SP
RỜI	R ỜI SP
RỜN	R Ờ N SP
RỠ	R Ỡ SP
RỠN	R Ỡ N SP
RỢ	R Ợ SP
RỢI	R ỢI SP
RỢN	R Ợ N SP
RỢP	R Ợ P SP
RỤC	R Ụ C SP
RỤNG	R Ụ NG SP
RỦ	R Ủ SP
RỦA	R ỦA SP
RỦI	R ỦI SP
RỦNG	R Ủ NG SP
RỨC	R Ứ C SP
RỨT	R Ứ T SP
RỪNG	R Ừ NG SP
RỬA	R ỬA SP
RỮA	R ỮA SP
RỰA	R ỰA SP
RỰC	R Ự C SP
SA	S A SP
SAI	S AI SP
SAM	S A M SP
SAN	S A N SP
SANG	S A NG SP
SANH	S A NH SP
SAO	S AO SP
SAU	S AU SP
SAY	S AY SP
SE	S E SP
SEN	S E N SP
SI	S I SP
SIM	S I M SP
SINH	S I NH SP
SIÊU	S IÊU SP
SIẾT	S IẾ T SP
SO	S O SP
SOI	S OI SP
SON	S O N SP
SONG	S O NG SP
SOÁT	S OÁ T SP
SOẠN	S OẠ N SP
SOẠNG	S OẠ NG SP
SOẠT	S OẠ T SP
SU	S U SP
SUM	S U M SP
SUN	S U N SP
SUNG	S U NG SP
SUY	S UY SP
SUYỂN	S UYỂ N SP
SUYỄN	S UYỄ N SP
SUÝT	S UÝ T SP
SUẤT	S UẤ T SP
SUỐI	S UỐI SP
SUỐT	S UỐ T SP
SÀ	S À SP
SÀI	S ÀI SP
SÀM	S À M SP
SÀN	S À N SP
SÀNG	S À NG SP
SÀNH	S À NH SP
SÀO	S ÀO SP
SÁ	S Á SP
SÁC	S Á C SP
SÁCH	S Á CH SP
SÁI	S ÁI SP
SÁNG	S Á NG SP
SÁNH	S Á NH SP
SÁO	S ÁO SP
SÁP	S Á P SP
SÁT	S Á T SP
SÁU	S ÁU SP
SÂM	S Â M SP
SÂN	S Â N SP
SÂU	S ÂU SP
SÃI	S ÃI SP
SÈO	S ÈO SP
SÉC	S É C SP
SÉT	S É T SP
SÊN	S Ê N SP
SÊNH	S Ê NH SP
SÊU	S ÊU SP
SÌ	S Ì SP
SÍNH	S Í NH SP
SÒ	S Ò SP
SÒNG	S Ò NG SP
SÓC	S Ó C SP
SÓI	S ÓI SP
SÓN	S Ó N SP
SÓNG	S Ó NG SP
SÓT	S Ó T SP
SÔ	S Ô SP
SÔI	S ÔI SP
SÔNG	S Ô NG SP
SÕI	S ÕI SP
SÙI	S ÙI SP
SÚ	S Ú SP
SÚC	S Ú C SP
SÚNG	S Ú NG SP
SÚP	S Ú P SP
SÚT	S Ú T SP
SÚY	S ÚY SP
SĂN	S Ă N SP
SĨ	S Ĩ SP
SŨNG	S Ũ NG SP
SƠ	S Ơ SP
SƠM	S Ơ M SP
SƠN	S Ơ N SP
SƯ	S Ư SP
SƯA	S ƯA SP
SƯNG	S Ư NG SP
SƯU	S ƯU SP
SƯƠNG	S ƯƠ NG SP
SƯỚNG	S ƯỚ NG SP
SƯỚT	S ƯỚ T SP
SƯỜN	S ƯỜ N SP
SƯỜNG	S ƯỜ NG SP
SƯỞI	S ƯỞI SP
SƯỢT	S ƯỢ T SP
SẠCH	S Ạ CH SP
SẠM	S Ạ M SP
SẠN	S Ạ N SP
SẠO	S ẠO SP
SẠP	S Ạ P SP
SẠT	S Ạ T SP
SẢN	S Ả N SP
SẢNG	S Ả NG SP
SẢNH	S Ả NH SP
SẢO	S ẢO SP
SẢY	S ẢY SP
SẤM	S Ấ M SP
SẤU	S ẤU SP
SẤY	S ẤY SP
SẦM	S Ầ M SP
SẦN	S Ầ N SP
SẦU	S ẦU SP
SẨN	S Ẩ N SP
SẨY	S ẨY SP
SẪM	S Ẫ M SP
SẬP	S Ậ P SP
SẮC	S Ắ C SP
SẮM	S Ắ M SP
SẮN	S Ắ N SP
SẮNG	S Ắ NG SP
SẮP	S Ắ P SP
SẮT	S Ắ T SP
SẴN	S Ẵ N SP
SẶC	S Ặ C SP
SẸM	S Ẹ M SP
SẸO	S ẸO SP
SẺ	S Ẻ SP
SẺN	S Ẻ N SP
SẼ	S Ẽ SP
SẾP	S Ế P SP
SẾU	S ẾU SP
SỀN	S Ề N SP
SỂ	S Ể SP
SỂNH	S Ể NH SP
SỄ	S Ễ SP
SỆT	S Ệ T SP
SỊT	S Ị T SP
SỌ	S Ọ SP
SỌM	S Ọ M SP
SỌT	S Ọ T SP
SỎ	S Ỏ SP
SỎI	S ỎI SP
SỐ	S Ố SP
SỐC	S Ố C SP
SỐNG	S Ố NG SP
SỐT	S Ố T SP
SỒ	S Ồ SP
SỒI	S ỒI SP
SỒN	S Ồ N SP
SỔ	S Ổ SP
SỖ	S Ỗ SP
SỘ	S Ộ SP
SỘT	S Ộ T SP
SỚ	S Ớ SP
SỚI	S ỚI SP
SỚM	S Ớ M SP
SỚN	S Ớ N SP
SỚT	S Ớ T SP
SỜ	S Ờ SP
SỜM	S Ờ M SP
SỜN	S Ờ N SP
SỞ	S Ở SP
SỠ	S Ỡ SP
SỢ	S Ợ SP
SỢI	S ỢI SP
SỤA	S ỤA SP
SỤC	S Ụ C SP
SỤN	S Ụ N SP
SỤT	S Ụ T SP
SỦA	S ỦA SP
SỦI	S ỦI SP
SỨ	S Ứ SP
SỨA	S ỨA SP
SỨC	S Ứ C SP
SỨT	S Ứ T SP
SỪNG	S Ừ NG SP
SỬ	S Ử SP
SỬA	S ỬA SP
SỬNG	S Ử NG SP
SỮA	S ỮA SP
SỮNG	S Ữ NG SP
SỰ	S Ự SP
SỰC	S Ự C SP
SỸ	S Ỹ SP
T	T  SP
TA	T A SP
TAI	T AI SP
TAM	T A M SP
TAN	T A N SP
TANG	T A NG SP
TANH	T A NH SP
TAO	T AO SP
TAY	T AY SP
TEM	T E M SP
TEN	T E N SP
TEO	T EO SP
THA	TH A SP
THAI	TH AI SP
THAM	TH A M SP
THAN	TH A N SP
THANG	TH A NG SP
THANH	TH A NH SP
THAO	TH AO SP
THAY	TH AY SP
THE	TH E SP
THEN	TH E N SP
THEO	TH EO SP
THI	TH I SP
THIA	TH IA SP
THIN	TH I N SP
THINH	TH I NH SP
THIÊM	TH IÊ M SP
THIÊN	TH IÊ N SP
THIÊNG	TH IÊ NG SP
THIẾC	TH IẾ C SP
THIẾP	TH IẾ P SP
THIẾT	TH IẾ T SP
THIẾU	TH IẾU SP
THIỀM	TH IỀ M SP
THIỀN	TH IỀ N SP
THIỀU	TH IỀU SP
THIỂN	TH IỂ N SP
THIỂU	TH IỂU SP
THIỆN	TH IỆ N SP
THIỆP	TH IỆ P SP
THIỆT	TH IỆ T SP
THIỆU	TH IỆU SP
THO	TH O SP
THOA	TH OA SP
THOANG	TH OA NG SP
THOI	TH OI SP
THON	TH O N SP
THONG	TH O NG SP
THOÁI	TH OÁI SP
THOÁNG	TH OÁ NG SP
THOÁT	TH OÁ T SP
THOĂN	TH OĂ N SP
THOẠI	TH OẠI SP
THOẠT	TH OẠ T SP
THOẢ	TH OẢ SP
THOẢI	TH OẢI SP
THOẢNG	TH OẢ NG SP
THOẮT	TH OẮ T SP
THU	TH U SP
THUA	TH UA SP
THUI	TH UI SP
THUN	TH U N SP
THUNG	TH U NG SP
THUYÊN	TH UYÊ N SP
THUYẾT	TH UYẾ T SP
THUYỀN	TH UYỀ N SP
THUÊ	TH UÊ SP
THUẦN	TH UẦ N SP
THUẪN	TH UẪ N SP
THUẬN	TH UẬ N SP
THUẬT	TH UẬ T SP
THUẾ	TH UẾ SP
THUỐC	TH UỐ C SP
THUỒNG	TH UỒ NG SP
THUỘC	TH UỘ C SP
THUỞ	TH UỞ SP
THUỶ	TH UỶ SP
THÀ	TH À SP
THÀI	TH ÀI SP
THÀNH	TH À NH SP
THÀO	TH ÀO SP
THÁC	TH Á C SP
THÁCH	TH Á CH SP
THÁI	TH ÁI SP
THÁM	TH Á M SP
THÁN	TH Á N SP
THÁNG	TH Á NG SP
THÁNH	TH Á NH SP
THÁO	TH ÁO SP
THÁP	TH Á P SP
THÂM	TH Â M SP
THÂN	TH Â N SP
THÂU	TH ÂU SP
THÂY	TH ÂY SP
THÃI	TH ÃI SP
THÈM	TH È M SP
THÈO	TH ÈO SP
THÉP	TH É P SP
THÉT	TH É T SP
THÊ	TH Ê SP
THÊM	TH Ê M SP
THÊNH	TH Ê NH SP
THÊU	TH ÊU SP
THÌ	TH Ì SP
THÌA	TH ÌA SP
THÌNH	TH Ì NH SP
THÌU	TH ÌU SP
THÍ	TH Í SP
THÍA	TH ÍA SP
THÍCH	TH Í CH SP
THÍM	TH Í M SP
THÍN	TH Í N SP
THÍNH	TH Í NH SP
THÍP	TH Í P SP
THÍT	TH Í T SP
THÒ	TH Ò SP
THÒI	TH ÒI SP
THÒNG	TH Ò NG SP
THÓ	TH Ó SP
THÓA	TH ÓA SP
THÓC	TH Ó C SP
THÓI	TH ÓI SP
THÓP	TH Ó P SP
THÓT	TH Ó T SP
THÔ	TH Ô SP
THÔI	TH ÔI SP
THÔN	TH Ô N SP
THÔNG	TH Ô NG SP
THÕNG	TH Õ NG SP
THÙ	TH Ù SP
THÙM	TH Ù M SP
THÙNG	TH Ù NG SP
THÙY	TH ÙY SP
THÚ	TH Ú SP
THÚC	TH Ú C SP
THÚNG	TH Ú NG SP
THÚT	TH Ú T SP
THÚY	TH ÚY SP
THĂM	TH Ă M SP
THĂNG	TH Ă NG SP
THŨNG	TH Ũ NG SP
THƠ	TH Ơ SP
THƠI	TH ƠI SP
THƠM	TH Ơ M SP
THƯ	TH Ư SP
THƯA	TH ƯA SP
THƯƠNG	TH ƯƠ NG SP
THƯỚC	TH ƯỚ C SP
THƯỜNG	TH ƯỜ NG SP
THƯỞNG	TH ƯỞ NG SP
THƯỠI	TH ƯỠI SP
THƯỠN	TH ƯỠ N SP
THƯỢC	TH ƯỢ C SP
THƯỢNG	TH ƯỢ NG SP
THẠC	TH Ạ C SP
THẠCH	TH Ạ CH SP
THẠNH	TH Ạ NH SP
THẠO	TH ẠO SP
THẢ	TH Ả SP
THẢI	TH ẢI SP
THẢM	TH Ả M SP
THẢN	TH Ả N SP
THẢNG	TH Ả NG SP
THẢNH	TH Ả NH SP
THẢO	TH ẢO SP
THẢY	TH ẢY SP
THẤM	TH Ấ M SP
THẤP	TH Ấ P SP
THẤT	TH Ấ T SP
THẤU	TH ẤU SP
THẤY	TH ẤY SP
THẦM	TH Ầ M SP
THẦN	TH Ầ N SP
THẦU	TH ẦU SP
THẦY	TH ẦY SP
THẨM	TH Ẩ M SP
THẨN	TH Ẩ N SP
THẪM	TH Ẫ M SP
THẪN	TH Ẫ N SP
THẬM	TH Ậ M SP
THẬN	TH Ậ N SP
THẬP	TH Ậ P SP
THẬT	TH Ậ T SP
THẮC	TH Ắ C SP
THẮN	TH Ắ N SP
THẮNG	TH Ắ NG SP
THẮP	TH Ắ P SP
THẮT	TH Ắ T SP
THẰN	TH Ằ N SP
THẰNG	TH Ằ NG SP
THẲM	TH Ẳ M SP
THẲNG	TH Ẳ NG SP
THẺ	TH Ẻ SP
THẾ	TH Ế SP
THẾCH	TH Ế CH SP
THẾP	TH Ế P SP
THỀ	TH Ề SP
THỀM	TH Ề M SP
THỀU	TH ỀU SP
THỂ	TH Ể SP
THỆ	TH Ệ SP
THỈ	TH Ỉ SP
THỈNH	TH Ỉ NH SP
THỊ	TH Ị SP
THỊCH	TH Ị CH SP
THỊNH	TH Ị NH SP
THỊT	TH Ị T SP
THỊU	TH ỊU SP
THỌ	TH Ọ SP
THỌC	TH Ọ C SP
THỌT	TH Ọ T SP
THỎ	TH Ỏ SP
THỎA	TH ỎA SP
THỎI	TH ỎI SP
THỎM	TH Ỏ M SP
THỐ	TH Ố SP
THỐI	TH ỐI SP
THỐN	TH Ố N SP
THỐNG	TH Ố NG SP
THỐT	TH Ố T SP
THỒ	TH Ồ SP
THỒI	TH ỒI SP
THỒN	TH Ồ N SP
THỔ	TH Ổ SP
THỔI	TH ỔI SP
THỚI	TH ỚI SP
THỚT	TH Ớ T SP
THỜ	TH Ờ SP
THỜI	TH ỜI SP
THỞ	TH Ở SP
THỢ	TH Ợ SP
THỤ	TH Ụ SP
THỤC	TH Ụ C SP
THỤNG	TH Ụ NG SP
THỤP	TH Ụ P SP
THỤT	TH Ụ T SP
THỤY	TH ỤY SP
THỦ	TH Ủ SP
THỦA	TH ỦA SP
THỦI	TH ỦI SP
THỦNG	TH Ủ NG SP
THỦY	TH ỦY SP
THỨ	TH Ứ SP
THỨC	TH Ứ C SP
THỪ	TH Ừ SP
THỪA	TH ỪA SP
THỪNG	TH Ừ NG SP
THỬ	TH Ử SP
THỬA	TH ỬA SP
THỮNG	TH Ữ NG SP
THỰ	TH Ự SP
THỰC	TH Ự C SP
TI	T I SP
TIA	T IA SP
TIM	T I M SP
TIN	T I N SP
TINH	T I NH SP
TIU	T IU SP
TIÊM	T IÊ M SP
TIÊN	T IÊ N SP
TIÊU	T IÊU SP
TIẾC	T IẾ C SP
TIẾM	T IẾ M SP
TIẾN	T IẾ N SP
TIẾNG	T IẾ NG SP
TIẾP	T IẾ P SP
TIẾT	T IẾ T SP
TIẾU	T IẾU SP
TIỀM	T IỀ M SP
TIỀN	T IỀ N SP
TIỂU	T IỂU SP
TIỄN	T IỄ N SP
TIỄU	T IỄU SP
TIỆC	T IỆ C SP
TIỆM	T IỆ M SP
TIỆN	T IỆ N SP
TO	T O SP
TOA	T OA SP
TOAN	T OA N SP
TOANH	T OA NH SP
TOE	T OE SP
TONG	T O NG SP
TOP	T O P SP
TOÀ	T OÀ SP
TOÀI	T OÀI SP
TOÀN	T OÀ N SP
TOÁI	T OÁI SP
TOÁN	T OÁ N SP
TOÁT	T OÁ T SP
TOÉT	T OÉ T SP
TOẠC	T OẠ C SP
TOẢ	T OẢ SP
TOẢN	T OẢ N SP
TOẸT	T OẸ T SP
TRA	TR A SP
TRAI	TR AI SP
TRANG	TR A NG SP
TRANH	TR A NH SP
TRAO	TR AO SP
TRAU	TR AU SP
TRE	TR E SP
TREO	TR EO SP
TRI	TR I SP
TRINH	TR I NH SP
TRIÊNG	TR IÊ NG SP
TRIẾT	TR IẾ T SP
TRIỀN	TR IỀ N SP
TRIỀNG	TR IỀ NG SP
TRIỀU	TR IỀU SP
TRIỂN	TR IỂ N SP
TRIỆNG	TR IỆ NG SP
TRIỆT	TR IỆ T SP
TRIỆU	TR IỆU SP
TRO	TR O SP
TRONG	TR O NG SP
TRU	TR U SP
TRUNG	TR U NG SP
TRUY	TR UY SP
TRUYỀN	TR UYỀ N SP
TRUYỆN	TR UYỆ N SP
TRUÂN	TR UÂ N SP
TRUẬT	TR UẬ T SP
TRUỒNG	TR UỒ NG SP
TRÀ	TR À SP
TRÀI	TR ÀI SP
TRÀM	TR À M SP
TRÀN	TR À N SP
TRÀNG	TR À NG SP
TRÀNH	TR À NH SP
TRÀO	TR ÀO SP
TRÁ	TR Á SP
TRÁCH	TR Á CH SP
TRÁI	TR ÁI SP
TRÁM	TR Á M SP
TRÁN	TR Á N SP
TRÁNG	TR Á NG SP
TRÁNH	TR Á NH SP
TRÁO	TR ÁO SP
TRÁP	TR Á P SP
TRÁT	TR Á T SP
TRÂM	TR Â M SP
TRÂN	TR Â N SP
TRÂU	TR ÂU SP
TRÃ	TR Ã SP
TRÃI	TR ÃI SP
TRÈO	TR ÈO SP
TRÉM	TR É M SP
TRÉO	TR ÉO SP
TRÊ	TR Ê SP
TRÊN	TR Ê N SP
TRÊU	TR ÊU SP
TRÌ	TR Ì SP
TRÌNH	TR Ì NH SP
TRÌU	TR ÌU SP
TRÍ	TR Í SP
TRÍCH	TR Í CH SP
TRÒ	TR Ò SP
TRÒN	TR Ò N SP
TRÒNG	TR Ò NG SP
TRÓC	TR Ó C SP
TRÓNG	TR Ó NG SP
TRÓT	TR Ó T SP
TRÔI	TR ÔI SP
TRÔM	TR Ô M SP
TRÔNG	TR Ô NG SP
TRÕN	TR Õ N SP
TRÙ	TR Ù SP
TRÙI	TR ÙI SP
TRÙM	TR Ù M SP
TRÙN	TR Ù N SP
TRÙNG	TR Ù NG SP
TRÚ	TR Ú SP
TRÚC	TR Ú C SP
TRÚM	TR Ú M SP
TRÚNG	TR Ú NG SP
TRÚT	TR Ú T SP
TRĂM	TR Ă M SP
TRĂN	TR Ă N SP
TRĂNG	TR Ă NG SP
TRĨ	TR Ĩ SP
TRĨU	TR ĨU SP
TRŨNG	TR Ũ NG SP
TRƠ	TR Ơ SP
TRƠI	TR ƠI SP
TRƠN	TR Ơ N SP
TRƯ	TR Ư SP
TRƯA	TR ƯA SP
TRƯNG	TR Ư NG SP
TRƯƠNG	TR ƯƠ NG SP
TRƯỚC	TR ƯỚ C SP
TRƯỚNG	TR ƯỚ NG SP
TRƯỜNG	TR ƯỜ NG SP
TRƯỞNG	TR ƯỞ NG SP
TRƯỠNG	TR ƯỠ NG SP
TRƯỢT	TR ƯỢ T SP
TRẠC	TR Ạ C SP
TRẠI	TR ẠI SP
TRẠM	TR Ạ M SP
TRẠNG	TR Ạ NG SP
TRẢ	TR Ả SP
TRẢI	TR ẢI SP
TRẢO	TR ẢO SP
TRẢU	TR ẢU SP
TRẤN	TR Ấ N SP
TRẤU	TR ẤU SP
TRẦM	TR Ầ M SP
TRẦN	TR Ầ N SP
TRẦU	TR ẦU SP
TRẦY	TR ẦY SP
TRẪM	TR Ẫ M SP
TRẬN	TR Ậ N SP
TRẬT	TR Ậ T SP
TRẮC	TR Ắ C SP
TRẮNG	TR Ắ NG SP
TRẰN	TR Ằ N SP
TRẶC	TR Ặ C SP
TRẶN	TR Ặ N SP
TRẸO	TR ẸO SP
TRẺ	TR Ẻ SP
TRẼN	TR Ẽ N SP
TRẾCH	TR Ế CH SP
TRỀ	TR Ề SP
TRỄ	TR Ễ SP
TRỆ	TR Ệ SP
TRỆT	TR Ệ T SP
TRỊ	TR Ị SP
TRỊA	TR ỊA SP
TRỊCH	TR Ị CH SP
TRỊNH	TR Ị NH SP
TRỊT	TR Ị T SP
TRỌ	TR Ọ SP
TRỌC	TR Ọ C SP
TRỌI	TR ỌI SP
TRỌN	TR Ọ N SP
TRỌNG	TR Ọ NG SP
TRỌT	TR Ọ T SP
TRỎ	TR Ỏ SP
TRỐN	TR Ố N SP
TRỐNG	TR Ố NG SP
TRỒ	TR Ồ SP
TRỒI	TR ỒI SP
TRỒNG	TR Ồ NG SP
TRỔ	TR Ổ SP
TRỘ	TR Ộ SP
TRỘM	TR Ộ M SP
TRỘN	TR Ộ N SP
TRỚ	TR Ớ SP
TRỚN	TR Ớ N SP
TRỜ	TR Ờ SP
TRỜI	TR ỜI SP
TRỞ	TR Ở SP
TRỢ	TR Ợ SP
TRỢN	TR Ợ N SP
TRỢT	TR Ợ T SP
TRỤ	TR Ụ SP
TRỤA	TR ỤA SP
TRỤC	TR Ụ C SP
TRỤI	TR ỤI SP
TRỤT	TR Ụ T SP
TRỤY	TR ỤY SP
TRỨ	TR Ứ SP
TRỨNG	TR Ứ NG SP
TRỪ	TR Ừ SP
TRỪNG	TR Ừ NG SP
TRỬNG	TR Ử NG SP
TRỮ	TR Ữ SP
TRỰC	TR Ự C SP
TU	T U SP
TUA	T UA SP
TUI	T UI SP
TUM	T U M SP
TUNG	T U NG SP
TUY	T UY SP
TUYÊN	T UYÊ N SP
TUYẾN	T UYẾ N SP
TUYẾT	T UYẾ T SP
TUYỀN	T UYỀ N SP
TUYỂN	T UYỂ N SP
TUYỆT	T UYỆ T SP
TUÂN	T UÂ N SP
TUÔN	T UÔ N SP
TUÔNG	T UÔ NG SP
TUẤN	T UẤ N SP
TUẦN	T UẦ N SP
TUẾ	T UẾ SP
TUỆ	T UỆ SP
TUỆCH	T UỆ CH SP
TUỐT	T UỐ T SP
TUỒN	T UỒ N SP
TUỒNG	T UỒ NG SP
TUỔI	T UỔI SP
TUỘT	T UỘ T SP
TUỲ	T UỲ SP
TY	T Y SP
TÀ	T À SP
TÀI	T ÀI SP
TÀN	T À N SP
TÀNG	T À NG SP
TÀNH	T À NH SP
TÀO	T ÀO SP
TÀU	T ÀU SP
TÀY	T ÀY SP
TÁ	T Á SP
TÁC	T Á C SP
TÁCH	T Á CH SP
TÁI	T ÁI SP
TÁM	T Á M SP
TÁN	T Á N SP
TÁNG	T Á NG SP
TÁNH	T Á NH SP
TÁO	T ÁO SP
TÁP	T Á P SP
TÁT	T Á T SP
TÁY	T ÁY SP
TÂM	T Â M SP
TÂN	T Â N SP
TÂY	T ÂY SP
TÃ	T Ã SP
TÃI	T ÃI SP
TÈ	T È SP
TÈN	T È N SP
TÉ	T É SP
TÉC	T É C SP
TÉM	T É M SP
TÉN	T É N SP
TÉP	T É P SP
TÉT	T É T SP
TÊ	T Ê SP
TÊN	T Ê N SP
TÌ	T Ì SP
TÌM	T Ì M SP
TÌNH	T Ì NH SP
TÍ	T Í SP
TÍA	T ÍA SP
TÍCH	T Í CH SP
TÍM	T Í M SP
TÍN	T Í N SP
TÍNH	T Í NH SP
TÍP	T Í P SP
TÍT	T Í T SP
TÍU	T ÍU SP
TÒ	T Ò SP
TÒA	T ÒA SP
TÒE	T ÒE SP
TÒI	T ÒI SP
TÒM	T Ò M SP
TÒNG	T Ò NG SP
TÓC	T Ó C SP
TÓE	T ÓE SP
TÓM	T Ó M SP
TÓP	T Ó P SP
TÔ	T Ô SP
TÔI	T ÔI SP
TÔM	T Ô M SP
TÔN	T Ô N SP
TÔNG	T Ô NG SP
TÙ	T Ù SP
TÙNG	T Ù NG SP
TÙY	T ÙY SP
TÚ	T Ú SP
TÚC	T Ú C SP
TÚI	T ÚI SP
TÚM	T Ú M SP
TÚNG	T Ú NG SP
TÚT	T Ú T SP
TÚY	T ÚY SP
TÝ	T Ý SP
TĂM	T Ă M SP
TĂN	T Ă N SP
TĂNG	T Ă NG SP
TĨNH	T Ĩ NH SP
TŨM	T Ũ M SP
TƠ	T Ơ SP
TƠI	T ƠI SP
TƯ	T Ư SP
TƯA	T ƯA SP
TƯNG	T Ư NG SP
TƯƠI	T ƯƠI SP
TƯƠM	T ƯƠ M SP
TƯƠNG	T ƯƠ NG SP
TƯỚC	T ƯỚ C SP
TƯỚI	T ƯỚI SP
TƯỚNG	T ƯỚ NG SP
TƯỜM	T ƯỜ M SP
TƯỜNG	T ƯỜ NG SP
TƯỜU	T ƯỜU SP
TƯỞI	T ƯỞI SP
TƯỞNG	T ƯỞ NG SP
TƯỢNG	T ƯỢ NG SP
TƯỢP	T ƯỢ P SP
TẠ	T Ạ SP
TẠCH	T Ạ CH SP
TẠI	T ẠI SP
TẠM	T Ạ M SP
TẠNG	T Ạ NG SP
TẠO	T ẠO SP
TẠP	T Ạ P SP
TẠT	T Ạ T SP
TẢ	T Ả SP
TẢI	T ẢI SP
TẢN	T Ả N SP
TẢNG	T Ả NG SP
TẢO	T ẢO SP
TẤC	T Ấ C SP
TẤM	T Ấ M SP
TẤN	T Ấ N SP
TẤP	T Ấ P SP
TẤT	T Ấ T SP
TẤU	T ẤU SP
TẤY	T ẤY SP
TẦM	T Ầ M SP
TẦN	T Ầ N SP
TẦNG	T Ầ NG SP
TẦY	T ẦY SP
TẨM	T Ẩ M SP
TẨN	T Ẩ N SP
TẨY	T ẨY SP
TẬM	T Ậ M SP
TẬN	T Ậ N SP
TẬP	T Ậ P SP
TẬT	T Ậ T SP
TẮC	T Ắ C SP
TẮM	T Ắ M SP
TẮN	T Ắ N SP
TẮT	T Ắ T SP
TẰM	T Ằ M SP
TẲN	T Ẳ N SP
TẶC	T Ặ C SP
TẶNG	T Ặ NG SP
TẸO	T ẸO SP
TẸP	T Ẹ P SP
TẺ	T Ẻ SP
TẾ	T Ế SP
TẾT	T Ế T SP
TẾU	T ẾU SP
TỂ	T Ể SP
TỄ	T Ễ SP
TỄNH	T Ễ NH SP
TỆ	T Ệ SP
TỆP	T Ệ P SP
TỈ	T Ỉ SP
TỈA	T ỈA SP
TỈM	T Ỉ M SP
TỈNH	T Ỉ NH SP
TỊ	T Ị SP
TỊCH	T Ị CH SP
TỊNH	T Ị NH SP
TỌA	T ỌA SP
TỌC	T Ọ C SP
TỌP	T Ọ P SP
TỎ	T Ỏ SP
TỎA	T ỎA SP
TỎI	T ỎI SP
TỐ	T Ố SP
TỐC	T Ố C SP
TỐI	T ỐI SP
TỐN	T Ố N SP
TỐNG	T Ố NG SP
TỐP	T Ố P SP
TỐT	T Ố T SP
TỒI	T ỒI SP
TỒN	T Ồ N SP
TỔ	T Ổ SP
TỔN	T Ổ N SP
TỔNG	T Ổ NG SP
TỘC	T Ộ C SP
TỘI	T ỘI SP
TỘT	T Ộ T SP
TỚ	T Ớ SP
TỚI	T ỚI SP
TỚN	T Ớ N SP
TỜ	T Ờ SP
TỞM	T Ở M SP
TỢ	T Ợ SP
TỢP	T Ợ P SP
TỤ	T Ụ SP
TỤC	T Ụ C SP
TỤI	T ỤI SP
TỤM	T Ụ M SP
TỤNG	T Ụ NG SP
TỤT	T Ụ T SP
TỤY	T ỤY SP
TỦ	T Ủ SP
TỦI	T ỦI SP
TỦM	T Ủ M SP
TỦN	T Ủ N SP
TỦY	T ỦY SP
TỨ	T Ứ SP
TỨC	T Ứ C SP
TỪ	T Ừ SP
TỪNG	T Ừ NG SP
TỬ	T Ử SP
TỬA	T ỬA SP
TỬU	T ỬU SP
TỰ	T Ự SP
TỰA	T ỰA SP
TỰU	T ỰU SP
TỴ	T Ỵ SP
TỶ	T Ỷ SP
U	U SP
UNG	U NG SP
UY	UY SP
UYÊN	UYÊ N SP
UYỂN	UYỂ N SP
UẤT	UẤ T SP
UẾ	UẾ SP
UỂ	UỂ SP
UỐN	UỐ N SP
UỐNG	UỐ NG SP
UỘT	UỘ T SP
UỴCH	UỴ CH SP
UỶ	UỶ SP
V	V  SP
VA	V A SP
VAI	V AI SP
VAN	V A N SP
VANG	V A NG SP
VANH	V A NH SP
VAO	V AO SP
VAY	V AY SP
VE	V E SP
VEN	V E N SP
VEO	V EO SP
VI	V I SP
VINH	V I NH SP
VIÊM	V IÊ M SP
VIÊN	V IÊ N SP
VIẾNG	V IẾ NG SP
VIẾT	V IẾ T SP
VIỀN	V IỀ N SP
VIỂN	V IỂ N SP
VIỄN	V IỄ N SP
VIỆC	V IỆ C SP
VIỆN	V IỆ N SP
VIỆT	V IỆ T SP
VO	V O SP
VOI	V OI SP
VON	V O N SP
VONG	V O NG SP
VU	V U SP
VUA	V UA SP
VUI	V UI SP
VUN	V U N SP
VUNG	V U NG SP
VUÔNG	V UÔ NG SP
VUỐT	V UỐ T SP
VUỘT	V UỘ T SP
VY	V Y SP
VÀ	V À SP
VÀI	V ÀI SP
VÀN	V À N SP
VÀNG	V À NG SP
VÀNH	V À NH SP
VÀO	V ÀO SP
VÀY	V ÀY SP
VÁ	V Á SP
VÁC	V Á C SP
VÁCH	V Á CH SP
VÁI	V ÁI SP
VÁN	V Á N SP
VÁNG	V Á NG SP
VÁNH	V Á NH SP
VÁT	V Á T SP
VÁY	V ÁY SP
VÂN	V Â N SP
VÂNG	V Â NG SP
VÂY	V ÂY SP
VÃ	V Ã SP
VÃI	V ÃI SP
VÃNH	V Ã NH SP
VÈO	V ÈO SP
VÉ	V É SP
VÉN	V É N SP
VÉT	V É T SP
VÊ	V Ê SP
VÊN	V Ê N SP
VÊNH	V Ê NH SP
VÌ	V Ì SP
VÍ	V Í SP
VÍA	V ÍA SP
VÍT	V Í T SP
VÍU	V ÍU SP
VÒ	V Ò SP
VÒI	V ÒI SP
VÒM	V Ò M SP
VÒNG	V Ò NG SP
VÓ	V Ó SP
VÓC	V Ó C SP
VÓT	V Ó T SP
VÔ	V Ô SP
VÔI	V ÔI SP
VÔNG	V Ô NG SP
VÕ	V Õ SP
VÕNG	V Õ NG SP
VÙ	V Ù SP
VÙI	V ÙI SP
VÙN	V Ù N SP
VÙNG	V Ù NG SP
VÚ	V Ú SP
VÚT	V Ú T SP
VĂN	V Ă N SP
VĂNG	V Ă NG SP
VĨ	V Ĩ SP
VĨNH	V Ĩ NH SP
VŨ	V Ũ SP
VŨNG	V Ũ NG SP
VƠ	V Ơ SP
VƯƠN	V ƯƠ N SP
VƯƠNG	V ƯƠ NG SP
VƯỚNG	V ƯỚ NG SP
VƯỜN	V ƯỜ N SP
VƯỞNG	V ƯỞ NG SP
VƯỢNG	V ƯỢ NG SP
VƯỢT	V ƯỢ T SP
VẠ	V Ạ SP
VẠC	V Ạ C SP
VẠCH	V Ạ CH SP
VẠM	V Ạ M SP
VẠN	V Ạ N SP
VẠT	V Ạ T SP
VẢ	V Ả SP
VẢI	V ẢI SP
VẢNG	V Ả NG SP
VẢY	V ẢY SP
VẤN	V Ấ N SP
VẤP	V Ấ P SP
VẤT	V Ấ T SP
VẤU	V ẤU SP
VẤY	V ẤY SP
VẦN	V Ầ N SP
VẦNG	V Ầ NG SP
VẦY	V ẦY SP
VẨN	V Ẩ N SP
VẨY	V ẨY SP
VẪN	V Ẫ N SP
VẪY	V ẪY SP
VẬN	V Ậ N SP
VẬT	V Ậ T SP
VẬY	V ẬY SP
VẮC	V Ắ C SP
VẮN	V Ắ N SP
VẮNG	V Ắ NG SP
VẮT	V Ắ T SP
VẰN	V Ằ N SP
VẰNG	V Ằ NG SP
VẲNG	V Ẳ NG SP
VẶC	V Ặ C SP
VẶN	V Ặ N SP
VẶT	V Ặ T SP
VẸN	V Ẹ N SP
VẸO	V ẸO SP
VẸT	V Ẹ T SP
VẺ	V Ẻ SP
VẼ	V Ẽ SP
VẾ	V Ế SP
VẾCH	V Ế CH SP
VẾT	V Ế T SP
VỀ	V Ề SP
VỆ	V Ệ SP
VỆN	V Ệ N SP
VỆT	V Ệ T SP
VỈ	V Ỉ SP
VỈA	V ỈA SP
VỊ	V Ị SP
VỊM	V Ị M SP
VỊN	V Ị N SP
VỊNH	V Ị NH SP
VỊT	V Ị T SP
VỌNG	V Ọ NG SP
VỌT	V Ọ T SP
VỎ	V Ỏ SP
VỎN	V Ỏ N SP
VỐN	V Ố N SP
VỒNG	V Ồ NG SP
VỖ	V Ỗ SP
VỘI	V ỘI SP
VỚ	V Ớ SP
VỚI	V ỚI SP
VỚT	V Ớ T SP
VỜ	V Ờ SP
VỜI	V ỜI SP
VỜN	V Ờ N SP
VỞ	V Ở SP
VỞN	V Ở N SP
VỠ	V Ỡ SP
VỢ	V Ợ SP
VỢI	V ỢI SP
VỢT	V Ợ T SP
VỤ	V Ụ SP
VỤN	V Ụ N SP
VỤNG	V Ụ NG SP
VỤT	V Ụ T SP
VỨT	V Ứ T SP
VỪA	V ỪA SP
VỪNG	V Ừ NG SP
VỬNG	V Ử NG SP
VỮA	V ỮA SP
VỮNG	V Ữ NG SP
VỰC	V Ự C SP
X	X  SP
XA	X A SP
XANG	X A NG SP
XANH	X A NH SP
XAO	X AO SP
XAY	X AY SP
XE	X E SP
XEM	X E M SP
XEN	X E N SP
XEO	X EO SP
XI	X I SP
XIA	X IA SP
XIN	X I N SP
XINH	X I NH SP
XIÊM	X IÊ M SP
XIÊU	X IÊU SP
XIẾC	X IẾ C SP
XIẾT	X IẾ T SP
XOA	X OA SP
XOAN	X OA N SP
XOANG	X OA NG SP
XOAY	X OAY SP
XOE	X OE SP
XOEN	X OE N SP
XOI	X OI SP
XOM	X O M SP
XON	X O N SP
XONG	X O NG SP
XOÀI	X OÀI SP
XOÀN	X OÀ N SP
XOÀNG	X OÀ NG SP
XOÁ	X OÁ SP
XOÁY	X OÁY SP
XOÈ	X OÈ SP
XOÈN	X OÈ N SP
XOÉT	X OÉ T SP
XOĂN	X OĂ N SP
XOẠC	X OẠ C SP
XOẢNG	X OẢ NG SP
XOẮN	X OẮ N SP
XOẸT	X OẸ T SP
XU	X U SP
XUA	X UA SP
XUI	X UI SP
XUM	X U M SP
XUNG	X U NG SP
XUYÊN	X UYÊ N SP
XUYẾN	X UYẾ N SP
XUÂN	X UÂ N SP
XUÊ	X UÊ SP
XUÔI	X UÔI SP
XUẤT	X UẤ T SP
XUẨN	X UẨ N SP
XUỂ	X UỂ SP
XUỐNG	X UỐ NG SP
XUỒNG	X UỒ NG SP
XY	X Y SP
XÀ	X À SP
XÀI	X ÀI SP
XÀM	X À M SP
XÀNG	X À NG SP
XÀO	X ÀO SP
XÁ	X Á SP
XÁC	X Á C SP
XÁCH	X Á CH SP
XÁM	X Á M SP
XÁN	X Á N SP
XÁO	X ÁO SP
XÁT	X Á T SP
XÂM	X Â M SP
XÂU	X ÂU SP
XÂY	X ÂY SP
XÃ	X Ã SP
XÈ	X È SP
XÈO	X ÈO SP
XÉ	X É SP
XÉT	X É T SP
XÊ	X Ê SP
XÊNH	X Ê NH SP
XÌ	X Ì SP
XÌU	X ÌU SP
XÍ	X Í SP
XÍCH	X Í CH SP
XÍNH	X Í NH SP
XÍT	X Í T SP
XÍU	X ÍU SP
XÒA	X ÒA SP
XÒNG	X Ò NG SP
XÓ	X Ó SP
XÓA	X ÓA SP
XÓC	X Ó C SP
XÓM	X Ó M SP
XÓT	X Ó T SP
XÔ	X Ô SP
XÔI	X ÔI SP
XÔM	X Ô M SP
XÔN	X Ô N SP
XÔNG	X Ô NG SP
XÕA	X ÕA SP
XÙ	X Ù SP
XÙM	X Ù M SP
XÚC	X Ú C SP
XÚM	X Ú M SP
XÚNG	X Ú NG SP
XĂM	X Ă M SP
XĂNG	X Ă NG SP
XƠ	X Ơ SP
XƠI	X ƠI SP
XƯA	X ƯA SP
XƯNG	X Ư NG SP
XƯƠNG	X ƯƠ NG SP
XƯỚNG	X ƯỚ NG SP
XƯỞNG	X ƯỞ NG SP
XẠ	X Ạ SP
XẠC	X Ạ C SP
XẠCH	X Ạ CH SP
XẠO	X ẠO SP
XẠP	X Ạ P SP
XẢ	X Ả SP
XẢM	X Ả M SP
XẢO	X ẢO SP
XẢY	X ẢY SP
XẤU	X ẤU SP
XẨM	X Ẩ M SP
XẨY	X ẨY SP
XẮC	X Ắ C SP
XẮN	X Ắ N SP
XẮT	X Ắ T SP
XẴNG	X Ẵ NG SP
XẸO	X ẸO SP
XẸP	X Ẹ P SP
XẺ	X Ẻ SP
XẺNG	X Ẻ NG SP
XẾ	X Ế SP
XẾCH	X Ế CH SP
XẾP	X Ế P SP
XỀNH	X Ề NH SP
XỂ	X Ể SP
XỆCH	X Ệ CH SP
XỈ	X Ỉ SP
XỈA	X ỈA SP
XỈN	X Ỉ N SP
XỈNH	X Ỉ NH SP
XỈU	X ỈU SP
XỊ	X Ị SP
XỊT	X Ị T SP
XỌC	X Ọ C SP
XỌP	X Ọ P SP
XỎ	X Ỏ SP
XỐC	X Ố C SP
XỐI	X ỐI SP
XỐN	X Ố N SP
XỐNG	X Ố NG SP
XỐP	X Ố P SP
XỒNG	X Ồ NG SP
XỔ	X Ổ SP
XỔI	X ỔI SP
XỔM	X Ổ M SP
XỔNG	X Ổ NG SP
XỘC	X Ộ C SP
XỘN	X Ộ N SP
XỚI	X ỚI SP
XỚT	X Ớ T SP
XỞ	X Ở SP
XỞI	X ỞI SP
XỢT	X Ợ T SP
XỤ	X Ụ SP
XỤC	X Ụ C SP
XỤI	X ỤI SP
XỨ	X Ứ SP
XỨNG	X Ứ NG SP
XỬ	X Ử SP
XỬA	X ỬA SP
XỬNG	X Ử NG SP
Y	Y SP
YÊN	YÊ N SP
YÊNG	YÊ NG SP
YÊU	YÊU SP
YẾM	YẾ M SP
YẾN	YẾ N SP
YẾU	YẾU SP
YỂM	YỂ M SP
À	À SP
ÀO	ÀO SP
Á	Á SP
ÁC	Á C SP
ÁCH	Á CH SP
ÁI	ÁI SP
ÁM	Á M SP
ÁN	Á N SP
ÁNH	Á NH SP
ÁO	ÁO SP
ÁP	Á P SP
ÁT	Á T SP
ÁY	ÁY SP
ÂM	Â M SP
ÂN	Â N SP
ÂU	ÂU SP
ÂY	ÂY SP
Ã	Ã SP
È	È SP
ÈO	ÈO SP
É	É SP
ÉN	É N SP
ÉO	ÉO SP
ÉP	É P SP
Ê	Ê SP
ÊM	Ê M SP
Ì	Ì SP
Í	Í SP
ÍCH	Í CH SP
ÍT	Í T SP
ÒA	ÒA SP
ÒNG	Ò NG SP
ÓC	Ó C SP
ÓE	ÓE SP
ÓI	ÓI SP
ÓNG	Ó NG SP
Ô	Ô SP
ÔI	ÔI SP
ÔM	Ô M SP
ÔN	Ô N SP
ÔNG	Ô NG SP
Ù	Ù SP
ÙA	ÙA SP
ÙN	Ù N SP
Ú	Ú SP
ÚA	ÚA SP
ÚM	Ú M SP
ÚNG	Ú NG SP
ÚP	Ú P SP
ÚT	Ú T SP
ÚY	ÚY SP
Ý	Ý SP
ĂM	Ă M SP
ĂN	Ă N SP
ĐA	Đ A SP
ĐAI	Đ AI SP
ĐAM	Đ A M SP
ĐAN	Đ A N SP
ĐANG	Đ A NG SP
ĐANH	Đ A NH SP
ĐAO	Đ AO SP
ĐAU	Đ AU SP
ĐAY	Đ AY SP
ĐE	Đ E SP
ĐEM	Đ E M SP
ĐEN	Đ E N SP
ĐEO	Đ EO SP
ĐI	Đ I SP
ĐIA	Đ IA SP
ĐINH	Đ I NH SP
ĐIÊN	Đ IÊ N SP
ĐIÊU	Đ IÊU SP
ĐIẾC	Đ IẾ C SP
ĐIẾM	Đ IẾ M SP
ĐIẾU	Đ IẾU SP
ĐIỀM	Đ IỀ M SP
ĐIỀN	Đ IỀ N SP
ĐIỀU	Đ IỀU SP
ĐIỂM	Đ IỂ M SP
ĐIỂN	Đ IỂ N SP
ĐIỂU	Đ IỂU SP
ĐIỆM	Đ IỆ M SP
ĐIỆN	Đ IỆ N SP
ĐIỆP	Đ IỆ P SP
ĐIỆU	Đ IỆU SP
ĐO	Đ O SP
ĐOAN	Đ OA N SP
ĐOM	Đ O M SP
ĐONG	Đ O NG SP
ĐOÀI	Đ OÀI SP
ĐOÀN	Đ OÀ N SP
ĐOÀNG	Đ OÀ NG SP
ĐOÁN	Đ OÁ N SP
ĐOẠN	Đ OẠ N SP
ĐOẠT	Đ OẠ T SP
ĐOẢNG	Đ OẢ NG SP
ĐU	Đ U SP
ĐUA	Đ UA SP
ĐUI	Đ UI SP
ĐUN	Đ U N SP
ĐUNG	Đ U NG SP
ĐUÔI	Đ UÔI SP
ĐUỐC	Đ UỐ C SP
ĐUỐI	Đ UỐI SP
ĐUỔI	Đ UỔI SP
ĐUỘT	Đ UỘ T SP
ĐÀ	Đ À SP
ĐÀI	Đ ÀI SP
ĐÀM	Đ À M SP
ĐÀN	Đ À N SP
ĐÀNG	Đ À NG SP
ĐÀNH	Đ À NH SP
ĐÀO	Đ ÀO SP
ĐÁ	Đ Á SP
ĐÁC	Đ Á C SP
ĐÁI	Đ ÁI SP
ĐÁM	Đ Á M SP
ĐÁNG	Đ Á NG SP
ĐÁNH	Đ Á NH SP
ĐÁO	Đ ÁO SP
ĐÁP	Đ Á P SP
ĐÁY	Đ ÁY SP
ĐÂM	Đ Â M SP
ĐÂU	Đ ÂU SP
ĐÂY	Đ ÂY SP
ĐÃ	Đ Ã SP
ĐÃI	Đ ÃI SP
ĐÃNG	Đ Ã NG SP
ĐÈ	Đ È SP
ĐÈN	Đ È N SP
ĐÈO	Đ ÈO SP
ĐÉC	Đ É C SP
ĐÉO	Đ ÉO SP
ĐÊ	Đ Ê SP
ĐÊM	Đ Ê M SP
ĐÊNH	Đ Ê NH SP
ĐÊU	Đ ÊU SP
ĐÌA	Đ ÌA SP
ĐÌNH	Đ Ì NH SP
ĐÌU	Đ ÌU SP
ĐÍCH	Đ Í CH SP
ĐÍNH	Đ Í NH SP
ĐÍT	Đ Í T SP
ĐÒ	Đ Ò SP
ĐÒI	Đ ÒI SP
ĐÒM	Đ Ò M SP
ĐÒN	Đ Ò N SP
ĐÒNG	Đ Ò NG SP
ĐÓ	Đ Ó SP
ĐÓA	Đ ÓA SP
ĐÓI	Đ ÓI SP
ĐÓM	Đ Ó M SP
ĐÓN	Đ Ó N SP
ĐÓNG	Đ Ó NG SP
ĐÔ	Đ Ô SP
ĐÔI	Đ ÔI SP
ĐÔN	Đ Ô N SP
ĐÔNG	Đ Ô NG SP
ĐÙA	Đ ÙA SP
ĐÙI	Đ ÙI SP
ĐÙM	Đ Ù M SP
ĐÙNG	Đ Ù NG SP
ĐÚ	Đ Ú SP
ĐÚC	Đ Ú C SP
ĐÚM	Đ Ú M SP
ĐÚNG	Đ Ú NG SP
ĐÚP	Đ Ú P SP
ĐÚT	Đ Ú T SP
ĐĂNG	Đ Ă NG SP
ĐĨ	Đ Ĩ SP
ĐĨA	Đ ĨA SP
ĐŨA	Đ ŨA SP
ĐŨNG	Đ Ũ NG SP
ĐƠ	Đ Ơ SP
ĐƠM	Đ Ơ M SP
ĐƠN	Đ Ơ N SP
ĐƯA	Đ ƯA SP
ĐƯƠNG	Đ ƯƠ NG SP
ĐƯỚC	Đ ƯỚ C SP
ĐƯỜNG	Đ ƯỜ NG SP
ĐƯỢC	Đ ƯỢ C SP
ĐẠC	Đ Ạ C SP
ĐẠCH	Đ Ạ CH SP
ĐẠI	Đ ẠI SP
ĐẠM	Đ Ạ M SP
ĐẠN	Đ Ạ N SP
ĐẠO	Đ ẠO SP
ĐẠP	Đ Ạ P SP
ĐẠT	Đ Ạ T SP
ĐẢ	Đ Ả SP
ĐẢM	Đ Ả M SP
ĐẢN	Đ Ả N SP
ĐẢNG	Đ Ả NG SP
ĐẢO	Đ ẢO SP
ĐẤM	Đ Ấ M SP
ĐẤT	Đ Ấ T SP
ĐẤU	Đ ẤU SP
ĐẤY	Đ ẤY SP
ĐẦM	Đ Ầ M SP
ĐẦU	Đ ẦU SP
ĐẦY	Đ ẦY SP
ĐẨU	Đ ẨU SP
ĐẨY	Đ ẨY SP
ĐẪM	Đ Ẫ M SP
ĐẪY	Đ ẪY SP
ĐẬM	Đ Ậ M SP
ĐẬN	Đ Ậ N SP
ĐẬP	Đ Ậ P SP
ĐẬT	Đ Ậ T SP
ĐẬU	Đ ẬU SP
ĐẬY	Đ ẬY SP
ĐẮC	Đ Ắ C SP
ĐẮM	Đ Ắ M SP
ĐẮN	Đ Ắ N SP
ĐẮNG	Đ Ắ NG SP
ĐẮP	Đ Ắ P SP
ĐẮT	Đ Ắ T SP
ĐẰM	Đ Ằ M SP
ĐẰNG	Đ Ằ NG SP
ĐẲNG	Đ Ẳ NG SP
ĐẶC	Đ Ặ C SP
ĐẶN	Đ Ặ N SP
ĐẶNG	Đ Ặ NG SP
ĐẶT	Đ Ặ T SP
ĐẸP	Đ Ẹ P SP
ĐẺ	Đ Ẻ SP
ĐẼ	Đ Ẽ SP
ĐẼO	Đ ẼO SP
ĐẾ	Đ Ế SP
ĐẾM	Đ Ế M SP
ĐẾN	Đ Ế N SP
ĐỀ	Đ Ề SP
ĐỀM	Đ Ề M SP
ĐỀN	Đ Ề N SP
ĐỀNH	Đ Ề NH SP
ĐỀU	Đ ỀU SP
ĐỂ	Đ Ể SP
ĐỂNH	Đ Ể NH SP
ĐỂU	Đ ỂU SP
ĐỄNH	Đ Ễ NH SP
ĐỆ	Đ Ệ SP
ĐỆM	Đ Ệ M SP
ĐỈNH	Đ Ỉ NH SP
ĐỊA	Đ ỊA SP
ĐỊCH	Đ Ị CH SP
ĐỊNH	Đ Ị NH SP
ĐỊU	Đ ỊU SP
ĐỌ	Đ Ọ SP
ĐỌC	Đ Ọ C SP
ĐỌNG	Đ Ọ NG SP
ĐỎ	Đ Ỏ SP
ĐỐ	Đ Ố SP
ĐỐC	Đ Ố C SP
ĐỐI	Đ ỐI SP
ĐỐM	Đ Ố M SP
ĐỐN	Đ Ố N SP
ĐỐNG	Đ Ố NG SP
ĐỐT	Đ Ố T SP
ĐỒ	Đ Ồ SP
ĐỒI	Đ ỒI SP
ĐỒN	Đ Ồ N SP
ĐỒNG	Đ Ồ NG SP
ĐỔ	Đ Ổ SP
ĐỔI	Đ ỔI SP
ĐỔNG	Đ Ổ NG SP
ĐỖ	Đ Ỗ SP
ĐỖI	Đ ỖI SP
ĐỘ	Đ Ộ SP
ĐỘC	Đ Ộ C SP
ĐỘI	Đ ỘI SP
ĐỘN	Đ Ộ N SP
ĐỘNG	Đ Ộ NG SP
ĐỘP	Đ Ộ P SP
ĐỘT	Đ Ộ T SP
ĐỚI	Đ ỚI SP
ĐỚN	Đ Ớ N SP
ĐỜ	Đ Ờ SP
ĐỜI	Đ ỜI SP
ĐỜM	Đ Ờ M SP
ĐỜN	Đ Ờ N SP
ĐỠ	Đ Ỡ SP
ĐỢI	Đ ỢI SP
ĐỢP	Đ Ợ P SP
ĐỢT	Đ Ợ T SP
ĐỤC	Đ Ụ C SP
ĐỤN	Đ Ụ N SP
ĐỤNG	Đ Ụ NG SP
ĐỦ	Đ Ủ SP
ĐỨA	Đ ỨA SP
ĐỨC	Đ Ứ C SP
ĐỨNG	Đ Ứ NG SP
ĐỨT	Đ Ứ T SP
ĐỪNG	Đ Ừ NG SP
ĐỰNG	Đ Ự NG SP
Ĩ	Ĩ SP
Ơ	Ơ SP
ƠI	ƠI SP
ƠN	Ơ N SP
Ư	Ư SP
ƯA	ƯA SP
ƯNG	Ư NG SP
ƯU	ƯU SP
ƯƠM	ƯƠ M SP
ƯƠNG	ƯƠ NG SP
ƯỚC	ƯỚ C SP
ƯỚP	ƯỚ P SP
ƯỚT	ƯỚ T SP
Ạ	Ạ SP
ẠCH	Ạ CH SP
ẠT	Ạ T SP
Ả	Ả SP
ẢM	Ả M SP
ẢNH	Ả NH SP
ẢO	ẢO SP
ẤM	Ấ M SP
ẤN	Ấ N SP
ẤP	Ấ P SP
ẤU	ẤU SP
ẤY	ẤY SP
ẦM	Ầ M SP
ẦU	ẦU SP
ẨM	Ẩ M SP
ẨN	Ẩ N SP
ẨU	ẨU SP
ẬM	Ậ M SP
ẮP	Ắ P SP
ẮT	Ắ T SP
ẰNG	Ằ NG SP
ẴM	Ẵ M SP
ẶC	Ặ C SP
ẺN	Ẻ N SP
Ế	Ế SP
ẾCH	Ế CH SP
ỀNH	Ề NH SP
ỆCH	Ệ CH SP
ỆN	Ệ N SP
ỈA	ỈA SP
ỈM	Ỉ M SP
ỈN	Ỉ N SP
ỈU	ỈU SP
ỊCH	Ị CH SP
ỌC	Ọ C SP
ỌE	ỌE SP
ỎI	ỎI SP
ỎN	Ỏ N SP
ỎNG	Ỏ NG SP
ỐC	Ố C SP
ỐM	Ố M SP
ỐNG	Ố NG SP
ỐP	Ố P SP
Ồ	Ồ SP
ỒN	Ồ N SP
ỒNG	Ồ NG SP
Ổ	Ổ SP
ỔI	ỔI SP
ỔN	Ổ N SP
ỔNG	Ổ NG SP
ỘC	Ộ C SP
ỘN	Ộ N SP
ỘP	Ộ P SP
Ớ	Ớ SP
ỚI	ỚI SP
ỚN	Ớ N SP
ỚT	Ớ T SP
Ờ	Ờ SP
Ở	Ở SP
Ợ	Ợ SP
Ụ	Ụ SP
ỤC	Ụ C SP
Ủ	Ủ SP
ỦA	ỦA SP
ỦI	ỦI SP
ỦN	Ủ N SP
ỦNG	Ủ NG SP
ỦY	ỦY SP
Ứ	Ứ SP
ỨA	ỨA SP
ỨC	Ứ C SP
ỨNG	Ứ NG SP
Ừ	Ừ SP
ỬNG	Ử NG SP
Ỷ	Ỷ SP
