A	A SP
AI	AI SP
AM	A M SP
AN	A N SP
ANG	A NG SP
ANH	A NH SP
AO	AO SP
AU	AU SP
B	B  SP
BA	B A SP
BAN	B A N SP
BANG	B A NG SP
BANH	B A NH SP
BAO	B AO SP
BAY	B AY SP
BE	B E SP
BEN	B E N SP
BENG	B E NG SP
BI	B I SP
BIA	B IA SP
BINH	B I NH SP
BIEEN	B IEE N SP
BIEENG	B IEE NG SP
BIEESC	B IEES C SP
BIEESM	B IEES M SP
BIEESN	B IEES N SP
BIEESNG	B IEES NG SP
BIEEST	B IEES T SP
BIEESU	B IEESU SP
BIEEFN	B IEEF N SP
BIEERN	B IEER N SP
BIEERU	B IEERU SP
BIEEJN	B IEEJ N SP
BIEEJT	B IEEJ T SP
BO	B O SP
BOA	B OA SP
BOM	B O M SP
BON	B O N SP
BONG	B O NG SP
BU	B U SP
BUNG	B U NG SP
BUOON	B UOO N SP
BUOONG	B UOO NG SP
BUYST	B UYS T SP
BUOOST	B UOOS T SP
BUOOFN	B UOOF N SP
BUOOFNG	B UOOF NG SP
BUOORI	B UOORI SP
BUOOJC	B UOOJ C SP
BAF	B AF SP
BAFI	B AFI SP
BAFN	B AF N SP
BAFNG	B AF NG SP
BAFNH	B AF NH SP
BAFO	B AFO SP
BAFU	B AFU SP
BAFY	B AFY SP
BAS	B AS SP
BASC	B AS C SP
BASCH	B AS CH SP
BASI	B ASI SP
BASM	B AS M SP
BASN	B AS N SP
BASNG	B AS NG SP
BASNH	B AS NH SP
BASO	B ASO SP
BAST	B AS T SP
BASU	B ASU SP
BAANG	B AA NG SP
BAAU	B AAU SP
BAAY	B AAY SP
BAX	B AX SP
BAXI	B AXI SP
BAXO	B AXO SP
BEF	B EF SP
BEFN	B EF N SP
BEFO	B EFO SP
BES	B ES SP
BESN	B ES N SP
BESNG	B ES NG SP
BESO	B ESO SP
BEST	B ES T SP
BEE	B EE SP
BEEN	B EE N SP
BEENH	B EE NH SP
BEEU	B EEU SP
BIF	B IF SP
BIFA	B IFA SP
BIFNH	B IF NH SP
BIFU	B IFU SP
BIS	B IS SP
BISCH	B IS CH SP
BISNH	B IS NH SP
BISU	B ISU SP
BOF	B OF SP
BOS	B OS SP
BOSC	B OS C SP
BOSI	B OSI SP
BOSN	B OS N SP
BOSNG	B OS NG SP
BOSP	B OS P SP
BOST	B OS T SP
BOOI	B OOI SP
BOONG	B OO NG SP
BOXM	B OX M SP
BOXNG	B OX NG SP
BUF	B UF SP
BUFA	B UFA SP
BUFI	B UFI SP
BUFN	B UF N SP
BUFNG	B UF NG SP
BUS	B US SP
BUSA	B USA SP
BUSN	B US N SP
BUSNG	B US NG SP
BUSP	B US P SP
BUST	B US T SP
BAWN	B AW N SP
BAWNG	B AW NG SP
BIXNH	B IX NH SP
BIXU	B IXU SP
BUXM	B UX M SP
BOW	B OW SP
BOWI	B OWI SP
BOWM	B OW M SP
BUWNG	B UW NG SP
BUWU	B UWU SP
BUWOWI	B UWOWI SP
BUWOWM	B UWOW M SP
BUWOWU	B UWOWU SP
BUWOWSC	B UWOWS C SP
BUWOWSNG	B UWOWS NG SP
BUWOWRI	B UWOWRI SP
BAJ	B AJ SP
BAJC	B AJ C SP
BAJCH	B AJ CH SP
BAJI	B AJI SP
BAJN	B AJ N SP
BAJO	B AJO SP
BAJT	B AJ T SP
BAR	B AR SP
BARN	B AR N SP
BARNG	B AR NG SP
BARNH	B AR NH SP
BARO	B ARO SP
BARY	B ARY SP
BAASC	B AAS C SP
BAASM	B AAS M SP
BAASP	B AAS P SP
BAAST	B AAS T SP
BAASU	B AASU SP
BAASY	B AASY SP
BAAFM	B AAF M SP
BAAFN	B AAF N SP
BAAFU	B AAFU SP
BAAFY	B AAFY SP
BAARM	B AAR M SP
BAARN	B AAR N SP
BAAXY	B AAXY SP
BAAJC	B AAJ C SP
BAAJN	B AAJ N SP
BAAJP	B AAJ P SP
BAAJT	B AAJ T SP
BAAJY	B AAJY SP
BAWSC	B AWS C SP
BAWSN	B AWS N SP
BAWSNG	B AWS NG SP
BAWSP	B AWS P SP
BAWST	B AWS T SP
BAWFM	B AWF M SP
BAWFNG	B AWF NG SP
BAWXNG	B AWX NG SP
BAWJM	B AWJ M SP
BAWJT	B AWJ T SP
BEJ	B EJ SP
BEJO	B EJO SP
BEJP	B EJ P SP
BEJT	B EJ T SP
BEXN	B EX N SP
BEES	B EES SP
BEESN	B EES N SP
BEESP	B EES P SP
BEEST	B EES T SP
BEEF	B EEF SP
BEEFN	B EEF N SP
BEEFNH	B EEF NH SP
BEEFU	B EEFU SP
BEER	B EER SP
BEEJ	B EEJ SP
BEEJCH	B EEJ CH SP
BEEJN	B EEJ N SP
BEEJNH	B EEJ NH SP
BEEJT	B EEJ T SP
BEEJU	B EEJU SP
BIR	B IR SP
BIRNH	B IR NH SP
BIRU	B IRU SP
BIJ	B IJ SP
BIJA	B IJA SP
BIJCH	B IJ CH SP
BIJN	B IJ N SP
BIJT	B IJ T SP
BIJU	B IJU SP
BOJ	B OJ SP
BOJC	B OJ C SP
BOJN	B OJ N SP
BOJNG	B OJ NG SP
BOJP	B OJ P SP
BOJT	B OJ T SP
BOR	B OR SP
BOOS	B OOS SP
BOOSC	B OOS C SP
BOOSI	B OOSI SP
BOOSN	B OOS N SP
BOOSNG	B OOS NG SP
BOOF	B OOF SP
BOOFI	B OOFI SP
BOOFN	B OOF N SP
BOOFNG	B OOF NG SP
BOOR	B OOR SP
BOORN	B OOR N SP
BOORNG	B OOR NG SP
BOOX	B OOX SP
BOOXNG	B OOX NG SP
BOOJ	B OOJ SP
BOOJC	B OOJ C SP
BOOJI	B OOJI SP
BOOJNG	B OOJ NG SP
BOOJT	B OOJ T SP
BOWSI	B OWSI SP
BOWST	B OWS T SP
BOWF	B OWF SP
BOWFI	B OWFI SP
BOWFM	B OWF M SP
BOWR	B OWR SP
BOWRI	B OWRI SP
BOWX	B OWX SP
BOWJ	B OWJ SP
BOWJM	B OWJ M SP
BOWJN	B OWJ N SP
BUJA	B UJA SP
BUJC	B UJ C SP
BUJI	B UJI SP
BUJNG	B UJ NG SP
BUJT	B UJ T SP
BURA	B URA SP
BURM	B UR M SP
BUWSC	B UWS C SP
BUWST	B UWS T SP
BUWFA	B UWFA SP
BUWFNG	B UWF NG SP
BUWRU	B UWRU SP
BUWXA	B UWXA SP
BUWJ	B UWJ SP
BUWJC	B UWJ C SP
C	C  SP
CA	C A SP
CAI	C AI SP
CAM	C A M SP
CAN	C A N SP
CANH	C A NH SP
CAO	C AO SP
CAY	C AY SP
CHA	CH A SP
CHAI	CH AI SP
CHAN	CH A N SP
CHANG	CH A NG SP
CHANH	CH A NH SP
CHAO	CH AO SP
CHAY	CH AY SP
CHE	CH E SP
CHEM	CH E M SP
CHEN	CH E N SP
CHENG	CH E NG SP
CHEO	CH EO SP
CHI	CH I SP
CHIA	CH IA SP
CHIM	CH I M SP
CHINH	CH I NH SP
CHIEEM	CH IEE M SP
CHIEEN	CH IEE N SP
CHIEENG	CH IEE NG SP
CHIEEU	CH IEEU SP
CHIEESC	CH IEES C SP
CHIEESM	CH IEES M SP
CHIEESN	CH IEES N SP
CHIEESNG	CH IEES NG SP
CHIEEST	CH IEES T SP
CHIEESU	CH IEESU SP
CHIEEFN	CH IEEF N SP
CHIEEFU	CH IEEFU SP
CHIEERU	CH IEERU SP
CHO	CH O SP
CHOANG	CH OA NG SP
CHONG	CH O NG SP
CHOAFNG	CH OAF NG SP
CHOASNG	CH OAS NG SP
CHOEFN	CH OEF N SP
CHOAJC	CH OAJ C SP
CHOAJNG	CH OAJ NG SP
CHOARNG	CH OAR NG SP
CHOAWST	CH OAWS T SP
CHU	CH U SP
CHUA	CH UA SP
CHUI	CH UI SP
CHUM	CH U M SP
CHUNG	CH U NG SP
CHUYEEN	CH UYEE N SP
CHUYEESN	CH UYEES N SP
CHUYEEFN	CH UYEEF N SP
CHUYEERN	CH UYEER N SP
CHUYEEJN	CH UYEEJ N SP
CHUOOI	CH UOOI SP
CHUOONG	CH UOO NG SP
CHUAARN	CH UAAR N SP
CHUOOSC	CH UOOS C SP
CHUOOSI	CH UOOSI SP
CHUOOST	CH UOOS T SP
CHUOOFI	CH UOOFI SP
CHUOOFN	CH UOOF N SP
CHUOOFNG	CH UOOF NG SP
CHUOOXI	CH UOOXI SP
CHUOOJC	CH UOOJ C SP
CHUOOJNG	CH UOOJ NG SP
CHUOOJT	CH UOOJ T SP
CHAF	CH AF SP
CHAFI	CH AFI SP
CHAFM	CH AF M SP
CHAFNG	CH AF NG SP
CHAFNH	CH AF NH SP
CHAFO	CH AFO SP
CHAFY	CH AFY SP
CHASC	CH AS C SP
CHASI	CH ASI SP
CHASN	CH AS N SP
CHASNH	CH AS NH SP
CHASO	CH ASO SP
CHAST	CH AS T SP
CHASU	CH ASU SP
CHASY	CH ASY SP
CHAAM	CH AA M SP
CHAAN	CH AA N SP
CHAAU	CH AAU SP
CHAX	CH AX SP
CHAXO	CH AXO SP
CHEF	CH EF SP
CHEFN	CH EF N SP
CHEFO	CH EFO SP
CHES	CH ES SP
CHESM	CH ES M SP
CHESN	CH ES N SP
CHESO	CH ESO SP
CHESP	CH ES P SP
CHEST	CH ES T SP
CHEE	CH EE SP
CHEEM	CH EE M SP
CHEENH	CH EE NH SP
CHIF	CH IF SP
CHIFM	CH IF M SP
CHIFU	CH IFU SP
CHIS	CH IS SP
CHISCH	CH IS CH SP
CHISN	CH IS N SP
CHISNH	CH IS NH SP
CHIST	CH IS T SP
CHOF	CH OF SP
CHOFNG	CH OF NG SP
CHOS	CH OS SP
CHOSE	CH OSE SP
CHOSI	CH OSI SP
CHOSNG	CH OS NG SP
CHOST	CH OS T SP
CHOON	CH OO N SP
CHOONG	CH OO NG SP
CHUF	CH UF SP
CHUFA	CH UFA SP
CHUFI	CH UFI SP
CHUFM	CH UF M SP
CHUS	CH US SP
CHUSA	CH USA SP
CHUSC	CH US C SP
CHUSI	CH USI SP
CHUSNG	CH US NG SP
CHUST	CH US T SP
CHAWM	CH AW M SP
CHAWN	CH AW N SP
CHAWNG	CH AW NG SP
CHIXN	CH IX N SP
CHUXI	CH UXI SP
CHUXN	CH UX N SP
CHOW	CH OW SP
CHOWI	CH OWI SP
CHUW	CH UW SP
CHUWA	CH UWA SP
CHUWNG	CH UW NG SP
CHUWOWNG	CH UWOW NG SP
CHUWOWSC	CH UWOWS C SP
CHUWOWSNG	CH UWOWS NG SP
CHUWOWFM	CH UWOWF M SP
CHUWOWJC	CH UWOWJ C SP
CHAJCH	CH AJ CH SP
CHAJM	CH AJ M SP
CHAJN	CH AJ N SP
CHAJNH	CH AJ NH SP
CHAJP	CH AJ P SP
CHAJY	CH AJY SP
CHAR	CH AR SP
CHARI	CH ARI SP
CHARO	CH ARO SP
CHARY	CH ARY SP
CHAASM	CH AAS M SP
CHAASN	CH AAS N SP
CHAASP	CH AAS P SP
CHAAST	CH AAS T SP
CHAASU	CH AASU SP
CHAAFM	CH AAF M SP
CHAAFU	CH AAFU SP
CHAARM	CH AAR M SP
CHAARN	CH AAR N SP
CHAAJM	CH AAJ M SP
CHAAJP	CH AAJ P SP
CHAAJT	CH AAJ T SP
CHAAJU	CH AAJU SP
CHAWSC	CH AWS C SP
CHAWSM	CH AWS M SP
CHAWSN	CH AWS N SP
CHAWSP	CH AWS P SP
CHAWST	CH AWS T SP
CHAWFM	CH AWF M SP
CHAWFN	CH AWF N SP
CHAWFNG	CH AWF NG SP
CHAWRNG	CH AWR NG SP
CHAWXN	CH AWX N SP
CHAWJN	CH AWJ N SP
CHAWJNG	CH AWJ NG SP
CHAWJT	CH AWJ T SP
CHEJN	CH EJ N SP
CHEJO	CH EJO SP
CHEJP	CH EJ P SP
CHER	CH ER SP
CHEX	CH EX SP
CHEXN	CH EX N SP
CHEES	CH EES SP
CHEEST	CH EES T SP
CHEEF	CH EEF SP
CHEEFNH	CH EEF NH SP
CHEERNH	CH EER NH SP
CHEEJCH	CH EEJ CH SP
CHIR	CH IR SP
CHIRNH	CH IR NH SP
CHIJ	CH IJ SP
CHIJT	CH IJ T SP
CHIJU	CH IJU SP
CHOJC	CH OJ C SP
CHOJI	CH OJI SP
CHOJN	CH OJ N SP
CHOJT	CH OJ T SP
CHOR	CH OR SP
CHORM	CH OR M SP
CHORN	CH OR N SP
CHOOSC	CH OOS C SP
CHOOSI	CH OOSI SP
CHOOSN	CH OOS N SP
CHOOSNG	CH OOS NG SP
CHOOST	CH OOS T SP
CHOOFI	CH OOFI SP
CHOOFM	CH OOF M SP
CHOOFN	CH OOF N SP
CHOOFNG	CH OOF NG SP
CHOORI	CH OORI SP
CHOOX	CH OOX SP
CHOOJP	CH OOJ P SP
CHOWS	CH OWS SP
CHOWSI	CH OWSI SP
CHOWF	CH OWF SP
CHOWFN	CH OWF N SP
CHOWR	CH OWR SP
CHOWJ	CH OWJ SP
CHOWJP	CH OWJ P SP
CHOWJT	CH OWJ T SP
CHUJC	CH UJ C SP
CHUJM	CH UJ M SP
CHUJP	CH UJ P SP
CHUR	CH UR SP
CHURNG	CH UR NG SP
CHUWS	CH UWS SP
CHUWSA	CH UWSA SP
CHUWSC	CH UWS C SP
CHUWSNG	CH UWS NG SP
CHUWF	CH UWF SP
CHUWFNG	CH UWF NG SP
CHUWRA	CH UWRA SP
CHUWRI	CH UWRI SP
CHUWRNG	CH UWR NG SP
CHUWX	CH UWX SP
CHUWXA	CH UWXA SP
CHUWXNG	CH UWX NG SP
CHUWJC	CH UWJ C SP
CO	C O SP
COI	C OI SP
CON	C O N SP
CONG	C O NG SP
CU	C U SP
CUA	C UA SP
CUN	C U N SP
CUNG	C U NG SP
CUOONG	C UOO NG SP
CUOOSC	C UOOS C SP
CUOOSI	C UOOSI SP
CUOOSN	C UOOS N SP
CUOOSNG	C UOOS NG SP
CUOOFN	C UOOF N SP
CUOOFNG	C UOOF NG SP
CUOOXM	C UOOX M SP
CUOOJC	C UOOJ C SP
CUOOJI	C UOOJI SP
CUOOJN	C UOOJ N SP
CAF	C AF SP
CAFI	C AFI SP
CAFNG	C AF NG SP
CAFNH	C AF NH SP
CAFO	C AFO SP
CAFU	C AFU SP
CAFY	C AFY SP
CAS	C AS SP
CASC	C AS C SP
CASCH	C AS CH SP
CASI	C ASI SP
CASM	C AS M SP
CASN	C AS N SP
CASNG	C AS NG SP
CASNH	C AS NH SP
CASO	C ASO SP
CASP	C AS P SP
CAST	C AS T SP
CASU	C ASU SP
CASY	C ASY SP
CAAM	C AA M SP
CAAN	C AA N SP
CAAU	C AAU SP
CAAY	C AAY SP
CAXI	C AXI SP
COF	C OF SP
COFI	C OFI SP
COFM	C OF M SP
COFN	C OF N SP
COFNG	C OF NG SP
COS	C OS SP
COSC	C OS C SP
COSNG	C OS NG SP
COSP	C OS P SP
COST	C OS T SP
COO	C OO SP
COOI	C OOI SP
COOM	C OO M SP
COON	C OO N SP
COONG	C OO NG SP
COXI	C OXI SP
COXNG	C OX NG SP
CUF	C UF SP
CUFI	C UFI SP
CUFN	C UF N SP
CUFNG	C UF NG SP
CUS	C US SP
CUSC	C US C SP
CUSI	C USI SP
CUSM	C US M SP
CUSNG	C US NG SP
CUSP	C US P SP
CUST	C US T SP
CAWM	C AW M SP
CAWN	C AW N SP
CAWNG	C AW NG SP
CUX	C UX SP
CUXI	C UXI SP
CUXN	C UX N SP
CUXNG	C UX NG SP
COW	C OW SP
COWI	C OWI SP
COWM	C OW M SP
COWN	C OW N SP
CUW	C UW SP
CUWA	C UWA SP
CUWNG	C UW NG SP
CUWU	C UWU SP
CUWOWNG	C UWOW NG SP
CUWOWSC	C UWOWS C SP
CUWOWSI	C UWOWSI SP
CUWOWSP	C UWOWS P SP
CUWOWFI	C UWOWFI SP
CUWOWFM	C UWOWF M SP
CUWOWFNG	C UWOWF NG SP
CUWOWXI	C UWOWXI SP
CUWOWXNG	C UWOWX NG SP
CAJC	C AJ C SP
CAJCH	C AJ CH SP
CAJM	C AJ M SP
CAJN	C AJ N SP
CAJNH	C AJ NH SP
CAJO	C AJO SP
CAJP	C AJ P SP
CAJU	C AJU SP
CAJY	C AJY SP
CAR	C AR SP
CARI	C ARI SP
CARM	C AR M SP
CARN	C AR N SP
CARNG	C AR NG SP
CARNH	C AR NH SP
CARO	C ARO SP
CAASM	C AAS M SP
CAASP	C AAS P SP
CAAST	C AAS T SP
CAASU	C AASU SP
CAASY	C AASY SP
CAAFM	C AAF M SP
CAAFN	C AAF N SP
CAAFU	C AAFU SP
CAAFY	C AAFY SP
CAARM	C AAR M SP
CAARN	C AAR N SP
CAARU	C AARU SP
CAAXNG	C AAX NG SP
CAAJN	C AAJ N SP
CAAJP	C AAJ P SP
CAAJT	C AAJ T SP
CAAJU	C AAJU SP
CAAJY	C AAJY SP
CAWSC	C AWS C SP
CAWSM	C AWS M SP
CAWSN	C AWS N SP
CAWSP	C AWS P SP
CAWST	C AWS T SP
CAWFM	C AWF M SP
CAWFN	C AWF N SP
CAWRNG	C AWR NG SP
CAWJM	C AWJ M SP
CAWJN	C AWJ N SP
CAWJP	C AWJ P SP
COJ	C OJ SP
COJC	C OJ C SP
COJN	C OJ N SP
COJNG	C OJ NG SP
COJP	C OJ P SP
COJT	C OJ T SP
COR	C OR SP
CORI	C ORI SP
CORM	C OR M SP
COOS	C OOS SP
COOSC	C OOS C SP
COOSI	C OOSI SP
COOSM	C OOS M SP
COOSNG	C OOS NG SP
COOST	C OOS T SP
COOF	C OOF SP
COOFM	C OOF M SP
COOFN	C OOF N SP
COOFNG	C OOF NG SP
COOR	C OOR SP
COORNG	C OOR NG SP
COOX	C OOX SP
COOXI	C OOXI SP
COOJ	C OOJ SP
COOJI	C OOJI SP
COOJNG	C OOJ NG SP
COOJP	C OOJ P SP
COOJT	C OOJ T SP
COWS	C OWS SP
COWF	C OWF SP
COWFI	C OWFI SP
COWRI	C OWRI SP
COWX	C OWX SP
COWJT	C OWJ T SP
CUJ	C UJ SP
CUJC	C UJ C SP
CUJI	C UJI SP
CUJM	C UJ M SP
CUJP	C UJ P SP
CUJT	C UJ T SP
CUR	C UR SP
CURA	C URA SP
CURI	C URI SP
CURNG	C UR NG SP
CUWS	C UWS SP
CUWSA	C UWSA SP
CUWSNG	C UWS NG SP
CUWSU	C UWSU SP
CUWF	C UWF SP
CUWFU	C UWFU SP
CUWR	C UWR SP
CUWRA	C UWRA SP
CUWRI	C UWRI SP
CUWRU	C UWRU SP
CUWX	C UWX SP
CUWJ	C UWJ SP
CUWJA	C UWJA SP
CUWJC	C UWJ C SP
CUWJU	C UWJU SP
D	D  SP
DA	D A SP
DAI	D AI SP
DANG	D A NG SP
DANH	D A NH SP
DAO	D AO SP
DI	D I SP
DIM	D I M SP
DINH	D I NH SP
DIEEM	D IEE M SP
DIEEN	D IEE N SP
DIEEU	D IEEU SP
DIEESC	D IEES C SP
DIEEST	D IEES T SP
DIEESU	D IEESU SP
DIEEFU	D IEEFU SP
DIEEXM	D IEEX M SP
DIEEXN	D IEEX N SP
DIEEJC	D IEEJ C SP
DIEEJM	D IEEJ M SP
DIEEJN	D IEEJ N SP
DIEEJP	D IEEJ P SP
DIEEJT	D IEEJ T SP
DIEEJU	D IEEJU SP
DO	D O SP
DOANH	D OA NH SP
DOI	D OI SP
DONG	D O NG SP
DOAXN	D OAX N SP
DU	D U SP
DUA	D UA SP
DUNG	D U NG SP
DUY	D UY SP
DUYEEN	D UYEE N SP
DUYEEJT	D UYEEJ T SP
DUOOXI	D UOOXI SP
DAF	D AF SP
DAFI	D AFI SP
DAFN	D AF N SP
DAFNG	D AF NG SP
DAFNH	D AF NH SP
DAFO	D AFO SP
DAFY	D AFY SP
DASC	D AS C SP
DASM	D AS M SP
DASN	D AS N SP
DASNG	D AS NG SP
DASO	D ASO SP
DAAM	D AA M SP
DAAN	D AA N SP
DAANG	D AA NG SP
DAAU	D AAU SP
DAAY	D AAY SP
DAX	D AX SP
DAXNG	D AX NG SP
DAXY	D AXY SP
DEF	D EF SP
DESP	D ES P SP
DEE	D EE SP
DIF	D IF SP
DIFU	D IFU SP
DIS	D IS SP
DISNH	D IS NH SP
DOF	D OF SP
DOFI	D OFI SP
DOFM	D OF M SP
DOFNG	D OF NG SP
DOS	D OS SP
DOSC	D OS C SP
DOSM	D OS M SP
DOOI	D OOI SP
DOONG	D OO NG SP
DOXI	D OXI SP
DOXNG	D OX NG SP
DUF	D UF SP
DUFI	D UFI SP
DUFNG	D UF NG SP
DUSM	D US M SP
DAWM	D AW M SP
DAWN	D AW N SP
DIX	D IX SP
DIXA	D IXA SP
DUXNG	D UX NG SP
DOWI	D OWI SP
DUW	D UW SP
DUWA	D UWA SP
DUWNG	D UW NG SP
DUWOWNG	D UWOW NG SP
DUWOWSI	D UWOWSI SP
DUWOWFNG	D UWOWF NG SP
DUWOWXNG	D UWOWX NG SP
DUWOWJC	D UWOWJ C SP
DUWOWJT	D UWOWJ T SP
DAJ	D AJ SP
DAJC	D AJ C SP
DAJI	D AJI SP
DAJM	D AJ M SP
DAJN	D AJ N SP
DAJNG	D AJ NG SP
DAJO	D AJO SP
DAJT	D AJ T SP
DAJY	D AJY SP
DAR	D AR SP
DARI	D ARI SP
DAASN	D AAS N SP
DAASP	D AAS P SP
DAASU	D AASU SP
DAASY	D AASY SP
DAAFM	D AAF M SP
DAAFN	D AAF N SP
DAAFU	D AAFU SP
DAARN	D AAR N SP
DAAXM	D AAX M SP
DAAXN	D AAX N SP
DAAXU	D AAXU SP
DAAXY	D AAXY SP
DAAJM	D AAJ M SP
DAAJP	D AAJ P SP
DAAJY	D AAJY SP
DAWST	D AWS T SP
DAWFN	D AWF N SP
DAWFNG	D AWF NG SP
DAWRNG	D AWR NG SP
DAWJC	D AWJ C SP
DAWJM	D AWJ M SP
DAWJN	D AWJ N SP
DEJP	D EJ P SP
DEJT	D EJ T SP
DERO	D ERO SP
DEES	D EES SP
DEEF	D EEF SP
DEEFNH	D EEF NH SP
DEEX	D EEX SP
DEEJT	D EEJ T SP
DIJ	D IJ SP
DIJCH	D IJ CH SP
DIJP	D IJ P SP
DIJU	D IJU SP
DOJA	D OJA SP
DOJC	D OJ C SP
DOJN	D OJ N SP
DORNG	D OR NG SP
DOOSC	D OOS C SP
DOOSI	D OOSI SP
DOOST	D OOS T SP
DOOFI	D OOFI SP
DOOFN	D OOF N SP
DOOX	D OOX SP
DOOXI	D OOXI SP
DOOJI	D OOJI SP
DOOJT	D OOJ T SP
DOWS	D OWS SP
DOWFI	D OWFI SP
DOWFN	D OWF N SP
DOWR	D OWR SP
DOWX	D OWX SP
DUJ	D UJ SP
DUJC	D UJ C SP
DUJNG	D UJ NG SP
DUWSA	D UWSA SP
DUWST	D UWS T SP
DUWFA	D UWFA SP
DUWFNG	D UWF NG SP
DUWR	D UWR SP
DUWRNG	D UWR NG SP
DUWX	D UWX SP
DUWJ	D UWJ SP
DUWJA	D UWJA SP
DUWJC	D UWJ C SP
DUWJNG	D UWJ NG SP
E	E SP
EM	E M SP
EO	EO SP
GA	G A SP
GAI	G AI SP
GAM	G A M SP
GAN	G A N SP
GANG	G A NG SP
GANH	G A NH SP
GAO	G AO SP
GAY	G AY SP
GEN	G E N SP
GHE	GH E SP
GHEN	GH E N SP
GHI	GH I SP
GHIM	GH I M SP
GHIEEFN	GH IEEF N SP
GHEF	GH EF SP
GHEFN	GH EF N SP
GHES	GH ES SP
GHESM	GH ES M SP
GHESP	GH ES P SP
GHEST	GH ES T SP
GHEE	GH EE SP
GHIF	GH IF SP
GHIFM	GH IF M SP
GHEJ	GH EJ SP
GHEJO	GH EJO SP
GHER	GH ER SP
GHEX	GH EX SP
GHEES	GH EES SP
GHEEF	GH EEF SP
GHEEFNH	GH EEF NH SP
GHEERNH	GH EER NH SP
GIA	GI A SP
GIAI	GI AI SP
GIAM	GI A M SP
GIAN	GI A N SP
GIANG	GI A NG SP
GIANH	GI A NH SP
GIAO	GI AO SP
GIEO	GI EO SP
GION	GI O N SP
GIUA	GI UA SP
GIUN	GI U N SP
GIAF	GI AF SP
GIAFN	GI AF N SP
GIAFNH	GI AF NH SP
GIAFU	GI AFU SP
GIAFY	GI AFY SP
GIAS	GI AS SP
GIASC	GI AS C SP
GIASM	GI AS M SP
GIASN	GI AS N SP
GIASNG	GI AS NG SP
GIASO	GI ASO SP
GIASP	GI AS P SP
GIAAY	GI AAY SP
GIAX	GI AX SP
GIAXN	GI AX N SP
GIAXY	GI AXY SP
GIEFM	GI EF M SP
GIES	GI ES SP
GIEENG	GI EE NG SP
GIOF	GI OF SP
GIOFN	GI OF N SP
GIOS	GI OS SP
GIOSN	GI OS N SP
GIOSNG	GI OS NG SP
GIOONG	GI OO NG SP
GIUFM	GI UF M SP
GIUS	GI US SP
GIUSP	GI US P SP
GIAWM	GI AW M SP
GIAWNG	GI AW NG SP
GIUX	GI UX SP
GIUXA	GI UXA SP
GIOW	GI OW SP
GIUWOWNG	GI UWOW NG SP
GIUWOWSNG	GI UWOWS NG SP
GIUWOWFNG	GI UWOWF NG SP
GIAJT	GI AJ T SP
GIAR	GI AR SP
GIARI	GI ARI SP
GIARM	GI AR M SP
GIARN	GI AR N SP
GIARNG	GI AR NG SP
GIARNH	GI AR NH SP
GIAASC	GI AAS C SP
GIAASM	GI AAS M SP
GIAASP	GI AAS P SP
GIAASU	GI AASU SP
GIAASY	GI AASY SP
GIAAFM	GI AAF M SP
GIAAFN	GI AAF N SP
GIAAFY	GI AAFY SP
GIAAXM	GI AAX M SP
GIAAJM	GI AAJ M SP
GIAAJN	GI AAJ N SP
GIAAJP	GI AAJ P SP
GIAAJT	GI AAJ T SP
GIAWST	GI AWS T SP
GIAWFM	GI AWF M SP
GIAWFNG	GI AWF NG SP
GIAWJC	GI AWJ C SP
GIAWJM	GI AWJ M SP
GIAWJN	GI AWJ N SP
GIAWJT	GI AWJ T SP
GIEJO	GI EJO SP
GIEESM	GI EES M SP
GIEESNG	GI EES NG SP
GIEEST	GI EES T SP
GIEEFNG	GI EEF NG SP
GIEEXU	GI EEXU SP
GIOJ	GI OJ SP
GIOJNG	GI OJ NG SP
GIOJT	GI OJ T SP
GIOR	GI OR SP
GIORI	GI ORI SP
GIORN	GI OR N SP
GIOOSNG	GI OOS NG SP
GIOOFNG	GI OOF NG SP
GIOOX	GI OOX SP
GIOWSI	GI OWSI SP
GIOWF	GI OWF SP
GIOWFI	GI OWFI SP
GIOWR	GI OWR SP
GIOWXN	GI OWX N SP
GIUJA	GI UJA SP
GIUJC	GI UJ C SP
GIURI	GI URI SP
GIUWX	GI UWX SP
GIUWXA	GI UWXA SP
GIUWJT	GI UWJ T SP
GO	G O SP
GOM	G O M SP
GU	G U SP
GUOOSC	G UOOS C SP
GUOOJC	G UOOJ C SP
GAF	G AF SP
GAFI	G AFI SP
GAFN	G AF N SP
GAFNG	G AF NG SP
GAFNH	G AF NH SP
GAFO	G AFO SP
GAFU	G AFU SP
GASC	G AS C SP
GASI	G ASI SP
GASN	G AS N SP
GASNH	G AS NH SP
GASO	G ASO SP
GASP	G AS P SP
GASY	G ASY SP
GAAN	G AA N SP
GAAY	G AAY SP
GAX	G AX SP
GAXI	G AXI SP
GAXY	G AXY SP
GIF	G IF SP
GIFN	G IF N SP
GIS	G IS SP
GOF	G OF SP
GOFN	G OF N SP
GOSA	G OSA SP
GOSC	G OS C SP
GOSI	G OSI SP
GOSP	G OS P SP
GOST	G OS T SP
GOO	G OO SP
GOON	G OO N SP
GOONG	G OO NG SP
GOX	G OX SP
GUF	G UF SP
GUS	G US SP
GUST	G US T SP
GAWM	G AW M SP
GUXI	G UXI SP
GUWOWM	G UWOW M SP
GUWOWNG	G UWOW NG SP
GUWOWFM	G UWOWF M SP
GUWOWFNG	G UWOWF NG SP
GUWOWJNG	G UWOWJ NG SP
GAJ	G AJ SP
GAJCH	G AJ CH SP
GAJN	G AJ N SP
GAJO	G AJO SP
GAJT	G AJ T SP
GAR	G AR SP
GARY	G ARY SP
GAASP	G AAS P SP
GAASU	G AASU SP
GAASY	G AASY SP
GAAFM	G AAF M SP
GAAFN	G AAF N SP
GAAFU	G AAFU SP
GAAFY	G AAFY SP
GAAXM	G AAX M SP
GAAXU	G AAXU SP
GAAJP	G AAJ P SP
GAAJT	G AAJ T SP
GAAJY	G AAJY SP
GAWSM	G AWS M SP
GAWSN	G AWS N SP
GAWSNG	G AWS NG SP
GAWSP	G AWS P SP
GAWST	G AWS T SP
GAWFN	G AWF N SP
GAWJM	G AWJ M SP
GAWJNG	G AWJ NG SP
GAWJP	G AWJ P SP
GAWJT	G AWJ T SP
GIR	G IR SP
GOJI	G OJI SP
GOJN	G OJ N SP
GOJT	G OJ T SP
GORI	G ORI SP
GORNG	G OR NG SP
GOOSC	G OOS C SP
GOOSI	G OOSI SP
GOOSM	G OOS M SP
GOOF	G OOF SP
GOOFM	G OOF M SP
GOOFNG	G OOF NG SP
GOOR	G OOR SP
GOOX	G OOX SP
GOOJI	G OOJI SP
GOOJP	G OOJ P SP
GOWSM	G OWS M SP
GOWFM	G OWF M SP
GOWRI	G OWRI SP
GOWX	G OWX SP
GOWJI	G OWJI SP
GOWJN	G OWJ N SP
GOWJT	G OWJ T SP
GUJC	G UJ C SP
GUWRI	G UWRI SP
H	H  SP
HA	H A SP
HAI	H AI SP
HAM	H A M SP
HAN	H A N SP
HANG	H A NG SP
HAO	H AO SP
HAY	H AY SP
HE	H E SP
HEM	H E M SP
HEN	H E N SP
HEO	H EO SP
HI	H I SP
HIA	H IA SP
HIU	H IU SP
HIEEN	H IEE N SP
HIEENG	H IEE NG SP
HIEESM	H IEES M SP
HIEESN	H IEES N SP
HIEESP	H IEES P SP
HIEESU	H IEESU SP
HIEEFN	H IEEF N SP
HIEERM	H IEER M SP
HIEERN	H IEER N SP
HIEERU	H IEERU SP
HIEEJN	H IEEJ N SP
HIEEJP	H IEEJ P SP
HIEEJU	H IEEJU SP
HO	H O SP
HOA	H OA SP
HOAN	H OA N SP
HOANG	H OA NG SP
HOAY	H OAY SP
HOI	H OI SP
HOM	H O M SP
HOAF	H OAF SP
HOAFI	H OAFI SP
HOAFN	H OAF N SP
HOAFNG	H OAF NG SP
HOAFNH	H OAF NH SP
HOAS	H OAS SP
HOASC	H OAS C SP
HOAXN	H OAX N SP
HOEST	H OES T SP
HOAJ	H OAJ SP
HOAJCH	H OAJ CH SP
HOAJI	H OAJI SP
HOAJN	H OAJ N SP
HOAJT	H OAJ T SP
HOARNG	H OAR NG SP
HOAWSC	H OAWS C SP
HOAWST	H OAWS T SP
HOAWRN	H OAWR N SP
HOAWJC	H OAWJ C SP
HU	H U SP
HUN	H U N SP
HUNG	H U NG SP
HUY	H UY SP
HUYNH	H UY NH SP
HUYEEN	H UYEE N SP
HUYEEST	H UYEES T SP
HUYEEFN	H UYEEF N SP
HUYEEXN	H UYEEX N SP
HUYEEJN	H UYEEJ N SP
HUYEEJT	H UYEEJ T SP
HUAAN	H UAA N SP
HUEE	H UEE SP
HUYST	H UYS T SP
HUOW	H UOW SP
HUAASN	H UAAS N SP
HUEES	H UEES SP
HUEESCH	H UEES CH SP
HUEEF	H UEEF SP
HUEEJ	H UEEJ SP
HUOOSNG	H UOOS NG SP
HUYFNH	H UYF NH SP
HUYR	H UYR SP
HY	H Y SP
HAF	H AF SP
HAFI	H AFI SP
HAFM	H AF M SP
HAFN	H AF N SP
HAFNG	H AF NG SP
HAFNH	H AF NH SP
HAFO	H AFO SP
HAFU	H AFU SP
HAS	H AS SP
HASI	H ASI SP
HASM	H AS M SP
HASN	H AS N SP
HASNG	H AS NG SP
HASO	H ASO SP
HAST	H AS T SP
HAAM	H AA M SP
HAAN	H AA N SP
HAXI	H AXI SP
HAXN	H AX N SP
HAXNG	H AX NG SP
HAXNH	H AX NH SP
HAXO	H AXO SP
HAXY	H AXY SP
HEF	H EF SP
HEFN	H EF N SP
HES	H ES SP
HESO	H ESO SP
HEST	H ES T SP
HEEN	H EE N SP
HEENH	H EE NH SP
HIF	H IF SP
HIFNH	H IF NH SP
HIS	H IS SP
HIST	H IS T SP
HOF	H OF SP
HOFA	H OFA SP
HOFN	H OF N SP
HOSA	H OSA SP
HOSC	H OS C SP
HOSI	H OSI SP
HOSM	H OS M SP
HOSNG	H OS NG SP
HOST	H OS T SP
HOO	H OO SP
HOOI	H OOI SP
HOOM	H OO M SP
HOON	H OO N SP
HOONG	H OO NG SP
HUFA	H UFA SP
HUFN	H UF N SP
HUFNG	H UF NG SP
HUS	H US SP
HUSC	H US C SP
HUSI	H USI SP
HUSNG	H US NG SP
HUSP	H US P SP
HUST	H US T SP
HUSY	H USY SP
HAWM	H AW M SP
HAWNG	H AW NG SP
HIXNH	H IX NH SP
HUX	H UX SP
HUXM	H UX M SP
HOWI	H OWI SP
HOWN	H OW N SP
HUW	H UW SP
HUWNG	H UW NG SP
HUWU	H UWU SP
HUWOWNG	H UWOW NG SP
HUWOWU	H UWOWU SP
HUWOWSC	H UWOWS C SP
HUWOWSM	H UWOWS M SP
HUWOWSNG	H UWOWS NG SP
HUWOWFNG	H UWOWF NG SP
HUWOWRNG	H UWOWR NG SP
HAJ	H AJ SP
HAJC	H AJ C SP
HAJCH	H AJ CH SP
HAJI	H AJI SP
HAJM	H AJ M SP
HAJN	H AJ N SP
HAJNG	H AJ NG SP
HAJNH	H AJ NH SP
HAJO	H AJO SP
HAJP	H AJ P SP
HAJT	H AJ T SP
HAR	H AR SP
HARI	H ARI SP
HARM	H AR M SP
HARO	H ARO SP
HAASNG	H AAS NG SP
HAASP	H AAS P SP
HAAST	H AAS T SP
HAASU	H AASU SP
HAAFM	H AAF M SP
HAAFU	H AAFU SP
HAAFY	H AAFY SP
HAARM	H AAR M SP
HAAXNG	H AAX NG SP
HAAJN	H AAJ N SP
HAAJP	H AAJ P SP
HAAJU	H AAJU SP
HAWSC	H AWS C SP
HAWSN	H AWS N SP
HAWSNG	H AWS NG SP
HAWST	H AWS T SP
HAWFN	H AWF N SP
HAWFNG	H AWF NG SP
HAWRN	H AWR N SP
HAWXNG	H AWX NG SP
HAWJC	H AWJ C SP
HEJ	H EJ SP
HEJN	H EJ N SP
HEJP	H EJ P SP
HERM	H ER M SP
HEESN	H EES N SP
HEEST	H EES T SP
HEEF	H EEF SP
HEER	H EER SP
HEERN	H EER N SP
HEERNH	H EER NH SP
HEEX	H EEX SP
HEEJ	H EEJ SP
HEEJT	H EEJ T SP
HIR	H IR SP
HIRNH	H IR NH SP
HOJ	H OJ SP
HOJA	H OJA SP
HOJC	H OJ C SP
HOJNG	H OJ NG SP
HOJP	H OJ P SP
HORA	H ORA SP
HORI	H ORI SP
HORM	H OR M SP
HORNG	H OR NG SP
HOOS	H OOS SP
HOOSC	H OOS C SP
HOOSI	H OOSI SP
HOOST	H OOS T SP
HOOF	H OOF SP
HOOFI	H OOFI SP
HOOFN	H OOF N SP
HOOFNG	H OOF NG SP
HOOR	H OOR SP
HOORI	H OORI SP
HOORM	H OOR M SP
HOORN	H OOR N SP
HOORNG	H OOR NG SP
HOOX	H OOX SP
HOOXN	H OOX N SP
HOOJ	H OOJ SP
HOOJC	H OOJ C SP
HOOJI	H OOJI SP
HOOJN	H OOJ N SP
HOOJP	H OOJ P SP
HOOJT	H OOJ T SP
HOWS	H OWS SP
HOWSN	H OWS N SP
HOWSP	H OWS P SP
HOWST	H OWS T SP
HOWFN	H OWF N SP
HOWR	H OWR SP
HOWRI	H OWRI SP
HOWJI	H OWJI SP
HOWJM	H OWJ M SP
HOWJP	H OWJ P SP
HUJ	H UJ SP
HUJC	H UJ C SP
HUJI	H UJI SP
HUJT	H UJ T SP
HUR	H UR SP
HURY	H URY SP
HUWSA	H UWSA SP
HUWSC	H UWS C SP
HUWSNG	H UWS NG SP
HUWF	H UWF SP
HUWFNG	H UWF NG SP
HUWXU	H UWXU SP
HUWJ	H UWJ SP
HUWJC	H UWJ C SP
HUWJU	H UWJU SP
I	I SP
IM	I M SP
IN	I N SP
INH	I NH SP
K	K  SP
KA	K A SP
KEM	K E M SP
KEN	K E N SP
KEO	K EO SP
KHA	KH A SP
KHAI	KH AI SP
KHAN	KH A N SP
KHANG	KH A NG SP
KHANH	KH A NH SP
KHAO	KH AO SP
KHE	KH E SP
KHEN	KH E N SP
KHEO	KH EO SP
KHI	KH I SP
KHINH	KH I NH SP
KHIEEM	KH IEE M SP
KHIEEN	KH IEE N SP
KHIEENG	KH IEE NG SP
KHIEEU	KH IEEU SP
KHIEESM	KH IEES M SP
KHIEESN	KH IEES N SP
KHIEESP	KH IEES P SP
KHIEEST	KH IEES T SP
KHIEESU	KH IEESU SP
KHIEERN	KH IEER N SP
KHO	KH O SP
KHOA	KH OA SP
KHOAI	KH OAI SP
KHOAN	KH OA N SP
KHOANG	KH OA NG SP
KHOANH	KH OA NH SP
KHOE	KH OE SP
KHOM	KH O M SP
KHOAS	KH OAS SP
KHOASC	KH OAS C SP
KHOASI	KH OASI SP
KHOASN	KH OAS N SP
KHOAST	KH OAS T SP
KHOEFO	KH OEFO SP
KHOEST	KH OES T SP
KHOAWN	KH OAW N SP
KHOARI	KH OARI SP
KHOARN	KH OAR N SP
KHOARNG	KH OAR NG SP
KHOARNH	KH OAR NH SP
KHOAWST	KH OAWS T SP
KHOER	KH OER SP
KHU	KH U SP
KHUA	KH UA SP
KHUM	KH U M SP
KHUNG	KH U NG SP
KHUY	KH UY SP
KHUYA	KH UYA SP
KHUYNH	KH UY NH SP
KHUYEEN	KH UYEE N SP
KHUYEESN	KH UYEES N SP
KHUYEEST	KH UYEES T SP
KHUAAN	KH UAA N SP
KHUAANG	KH UAA NG SP
KHUAAY	KH UAAY SP
KHUOON	KH UOO N SP
KHUAAST	KH UAAS T SP
KHUAASY	KH UAASY SP
KHUAARN	KH UAAR N SP
KHUYFNH	KH UYF NH SP
KHUYRU	KH UYRU SP
KHAFN	KH AF N SP
KHAFNG	KH AF NG SP
KHAS	KH AS SP
KHASC	KH AS C SP
KHASCH	KH AS CH SP
KHASI	KH ASI SP
KHASM	KH AS M SP
KHASN	KH AS N SP
KHASNG	KH AS NG SP
KHASNH	KH AS NH SP
KHASO	KH ASO SP
KHASP	KH AS P SP
KHAST	KH AS T SP
KHAAM	KH AA M SP
KHAAU	KH AAU SP
KHEF	KH EF SP
KHEFN	KH EF N SP
KHEFO	KH EFO SP
KHESN	KH ES N SP
KHESO	KH ESO SP
KHESP	KH ES P SP
KHEST	KH ES T SP
KHEE	KH EE SP
KHIS	KH IS SP
KHISA	KH ISA SP
KHISCH	KH IS CH SP
KHIST	KH IS T SP
KHISU	KH ISU SP
KHOF	KH OF SP
KHOS	KH OS SP
KHOSA	KH OSA SP
KHOSC	KH OS C SP
KHOSE	KH OSE SP
KHOSI	KH OSI SP
KHOO	KH OO SP
KHOOI	KH OOI SP
KHOON	KH OO N SP
KHOONG	KH OO NG SP
KHUF	KH UF SP
KHUS	KH US SP
KHUSC	KH US C SP
KHUSM	KH US M SP
KHAWM	KH AW M SP
KHAWN	KH AW N SP
KHOW	KH OW SP
KHOWI	KH OWI SP
KHUW	KH UW SP
KHUWOWM	KH UWOW M SP
KHUWOWN	KH UWOW N SP
KHUWOWNG	KH UWOW NG SP
KHUWOWSC	KH UWOWS C SP
KHAJC	KH AJ C SP
KHAJNG	KH AJ NG SP
KHAR	KH AR SP
KHARI	KH ARI SP
KHARO	KH ARO SP
KHARY	KH ARY SP
KHAASN	KH AAS N SP
KHAASP	KH AAS P SP
KHAAST	KH AAS T SP
KHAASU	KH AASU SP
KHAARN	KH AAR N SP
KHAARU	KH AARU SP
KHAAJT	KH AAJ T SP
KHAWSC	KH AWS C SP
KHAWSM	KH AWS M SP
KHAWSNG	KH AWS NG SP
KHAWSP	KH AWS P SP
KHAWST	KH AWS T SP
KHAWRM	KH AWR M SP
KHAWRNG	KH AWR NG SP
KHER	KH ER SP
KHEX	KH EX SP
KHEES	KH EES SP
KHEEFU	KH EEFU SP
KHEEJ	KH EEJ SP
KHEEJNH	KH EEJ NH SP
KHIR	KH IR SP
KHIJT	KH IJ T SP
KHORA	KH ORA SP
KHORE	KH ORE SP
KHORI	KH ORI SP
KHOOS	KH OOS SP
KHOOSC	KH OOS C SP
KHOOSI	KH OOSI SP
KHOOSN	KH OOS N SP
KHOOSNG	KH OOS NG SP
KHOOR	KH OOR SP
KHOORNG	KH OOR NG SP
KHOWS	KH OWS SP
KHOWSP	KH OWS P SP
KHOWF	KH OWF SP
KHOWRI	KH OWRI SP
KHUJ	KH UJ SP
KHURNG	KH UR NG SP
KHUWS	KH UWS SP
KHUWSU	KH UWSU SP
KHUWF	KH UWF SP
KHUWJNG	KH UWJ NG SP
KI	K I SP
KIA	K IA SP
KIM	K I M SP
KINH	K I NH SP
KIEEM	K IEE M SP
KIEEN	K IEE N SP
KIEENG	K IEE NG SP
KIEEU	K IEEU SP
KIEESM	K IEES M SP
KIEESN	K IEES N SP
KIEESP	K IEES P SP
KIEEFM	K IEEF M SP
KIEEFN	K IEEF N SP
KIEEFNG	K IEEF NG SP
KIEEFU	K IEEFU SP
KIEERM	K IEER M SP
KIEERNG	K IEER NG SP
KIEERU	K IEERU SP
KIEEJM	K IEEJ M SP
KIEEJN	K IEEJ N SP
KIEEJT	K IEEJ T SP
KIEEJU	K IEEJU SP
KO	K O SP
KY	K Y SP
KEF	K EF SP
KEFM	K EF M SP
KEFN	K EF N SP
KEFO	K EFO SP
KESM	K ES M SP
KESN	K ES N SP
KESO	K ESO SP
KESP	K ES P SP
KEST	K ES T SP
KEE	K EE SP
KEENH	K EE NH SP
KEEU	K EEU SP
KIF	K IF SP
KIFA	K IFA SP
KIFM	K IF M SP
KIFNH	K IF NH SP
KIS	K IS SP
KISCH	K IS CH SP
KISN	K IS N SP
KISNH	K IS NH SP
KISP	K IS P SP
KIST	K IS T SP
KYS	K YS SP
KIX	K IX SP
KEJN	K EJ N SP
KEJO	K EJO SP
KEJP	K EJ P SP
KEJT	K EJ T SP
KER	K ER SP
KERNG	K ER NG SP
KERO	K ERO SP
KEX	K EX SP
KEXM	K EX M SP
KEXO	K EXO SP
KEES	K EES SP
KEESCH	K EES CH SP
KEEST	K EES T SP
KEEF	K EEF SP
KEEFN	K EEF N SP
KEEFNH	K EEF NH SP
KEER	K EER SP
KEEJ	K EEJ SP
KEEJNH	K EEJ NH SP
KIR	K IR SP
KIRNH	K IR NH SP
KIJ	K IJ SP
KIJCH	K IJ CH SP
KIJP	K IJ P SP
KIJT	K IJ T SP
KYF	K YF SP
KYJ	K YJ SP
KYR	K YR SP
KYX	K YX SP
LA	L A SP
LAI	L AI SP
LAM	L A M SP
LAN	L A N SP
LANG	L A NG SP
LANH	L A NH SP
LAO	L AO SP
LAU	L AU SP
LAY	L AY SP
LE	L E SP
LEM	L E M SP
LEN	L E N SP
LEO	L EO SP
LI	L I SP
LIA	L IA SP
LIM	L I M SP
LIN	L I N SP
LINH	L I NH SP
LIU	L IU SP
LIEEM	L IEE M SP
LIEEN	L IEE N SP
LIEENG	L IEE NG SP
LIEEU	L IEEU SP
LIEESC	L IEES C SP
LIEESM	L IEES M SP
LIEESN	L IEES N SP
LIEESNG	L IEES NG SP
LIEEFM	L IEEF M SP
LIEEFN	L IEEF N SP
LIEEFU	L IEEFU SP
LIEEXU	L IEEXU SP
LIEEJNG	L IEEJ NG SP
LIEEJT	L IEEJ T SP
LIEEJU	L IEEJU SP
LO	L O SP
LOA	L OA SP
LOAN	L OA N SP
LOANH	L OA NH SP
LOAY	L OAY SP
LOI	L OI SP
LOM	L O M SP
LONG	L O NG SP
LOAFI	L OAFI SP
LOAFN	L OAF N SP
LOAFNG	L OAF NG SP
LOAXNG	L OAX NG SP
LOES	L OES SP
LOEST	L OES T SP
LOAJI	L OAJI SP
LOAJN	L OAJ N SP
LOAJNG	L OAJ NG SP
LOAJT	L OAJ T SP
LOARNG	L OAR NG SP
LOAWST	L OAWS T SP
LOAWFNG	L OAWF NG SP
LU	L U SP
LUI	L UI SP
LUNG	L U NG SP
LUYEESN	L UYEES N SP
LUYEEJN	L UYEEJ N SP
LUAAN	L UAA N SP
LUOON	L UOO N SP
LUAARN	L UAAR N SP
LUAAJN	L UAAJ N SP
LUAAJT	L UAAJ T SP
LUOOSNG	L UOOS NG SP
LUOOFN	L UOOF N SP
LUOOFNG	L UOOF NG SP
LUOOXNG	L UOOX NG SP
LUOOJC	L UOOJ C SP
LY	L Y SP
LAF	L AF SP
LAFI	L AFI SP
LAFM	L AF M SP
LAFN	L AF N SP
LAFNG	L AF NG SP
LAFNH	L AF NH SP
LAFO	L AFO SP
LAFU	L AFU SP
LAS	L AS SP
LASC	L AS C SP
LASCH	L AS CH SP
LASI	L ASI SP
LASNG	L AS NG SP
LASNH	L AS NH SP
LASO	L ASO SP
LASP	L AS P SP
LAST	L AS T SP
LASU	L ASU SP
LASY	L ASY SP
LAAM	L AA M SP
LAAN	L AA N SP
LAANG	L AA NG SP
LAAU	L AAU SP
LAAY	L AAY SP
LAX	L AX SP
LAXI	L AXI SP
LAXM	L AX M SP
LAXN	L AX N SP
LAXNG	L AX NG SP
LAXNH	L AX NH SP
LAXO	L AXO SP
LEF	L EF SP
LEFO	L EFO SP
LES	L ES SP
LESC	L ES C SP
LESM	L ES M SP
LESN	L ES N SP
LESNG	L ES NG SP
LESO	L ESO SP
LESP	L ES P SP
LEST	L ES T SP
LEE	L EE SP
LEEN	L EE N SP
LEENH	L EE NH SP
LEEU	L EEU SP
LIF	L IF SP
LIFA	L IFA SP
LIFM	L IF M SP
LIS	L IS SP
LISNH	L IS NH SP
LISP	L IS P SP
LIST	L IS T SP
LISU	L ISU SP
LOF	L OF SP
LOFA	L OFA SP
LOFI	L OFI SP
LOFM	L OF M SP
LOFNG	L OF NG SP
LOSC	L OS C SP
LOSE	L OSE SP
LOSM	L OS M SP
LOSNG	L OS NG SP
LOST	L OS T SP
LOO	L OO SP
LOOI	L OOI SP
LOOM	L OO M SP
LOONG	L OO NG SP
LOXI	L OXI SP
LOXM	L OX M SP
LOXNG	L OX NG SP
LUF	L UF SP
LUFA	L UFA SP
LUFI	L UFI SP
LUFM	L UF M SP
LUFNG	L UF NG SP
LUS	L US SP
LUSA	L USA SP
LUSC	L US C SP
LUSI	L USI SP
LUSM	L US M SP
LUSN	L US N SP
LUSNG	L US NG SP
LYS	L YS SP
LAWM	L AW M SP
LAWN	L AW N SP
LAWNG	L AW NG SP
LIXNH	L IX NH SP
LUX	L UX SP
LUXI	L UXI SP
LUXM	L UX M SP
LUXN	L UX N SP
LUXNG	L UX NG SP
LUXY	L UXY SP
LOW	L OW SP
LOWI	L OWI SP
LOWN	L OW N SP
LUW	L UW SP
LUWNG	L UW NG SP
LUWU	L UWU SP
LUWOWM	L UWOW M SP
LUWOWN	L UWOW N SP
LUWOWNG	L UWOW NG SP
LUWOWSI	L UWOWSI SP
LUWOWSNG	L UWOWS NG SP
LUWOWST	L UWOWS T SP
LUWOWFI	L UWOWFI SP
LUWOWFNG	L UWOWF NG SP
LUWOWXI	L UWOWXI SP
LUWOWXNG	L UWOWX NG SP
LUWOWJC	L UWOWJ C SP
LUWOWJM	L UWOWJ M SP
LUWOWJN	L UWOWJ N SP
LUWOWJNG	L UWOWJ NG SP
LUWOWJT	L UWOWJ T SP
LAJ	L AJ SP
LAJC	L AJ C SP
LAJCH	L AJ CH SP
LAJI	L AJI SP
LAJM	L AJ M SP
LAJN	L AJ N SP
LAJNG	L AJ NG SP
LAJNH	L AJ NH SP
LAJO	L AJO SP
LAJP	L AJ P SP
LAJT	L AJ T SP
LAJY	L AJY SP
LAR	L AR SP
LARI	L ARI SP
LARM	L AR M SP
LARNG	L AR NG SP
LARNH	L AR NH SP
LAASM	L AAS M SP
LAASN	L AAS N SP
LAASP	L AAS P SP
LAAST	L AAS T SP
LAASY	L AASY SP
LAAFM	L AAF M SP
LAAFN	L AAF N SP
LAAFU	L AAFU SP
LAAFY	L AAFY SP
LAARM	L AAR M SP
LAARN	L AAR N SP
LAARU	L AARU SP
LAAXN	L AAX N SP
LAAXY	L AAXY SP
LAAJN	L AAJ N SP
LAAJP	L AAJ P SP
LAAJT	L AAJ T SP
LAAJU	L AAJU SP
LAWSC	L AWS C SP
LAWSM	L AWS M SP
LAWSNG	L AWS NG SP
LAWSP	L AWS P SP
LAWST	L AWS T SP
LAWFN	L AWF N SP
LAWFNG	L AWF NG SP
LAWRM	L AWR M SP
LAWRN	L AWR N SP
LAWRNG	L AWR NG SP
LAWJM	L AWJ M SP
LAWJN	L AWJ N SP
LAWJNG	L AWJ NG SP
LAWJP	L AWJ P SP
LAWJT	L AWJ T SP
LEJ	L EJ SP
LEJM	L EJ M SP
LER	L ER SP
LERN	L ER N SP
LERNG	L ER NG SP
LEX	L EX SP
LEXN	L EX N SP
LEXO	L EXO SP
LEEST	L EES T SP
LEESU	L EESU SP
LEEF	L EEF SP
LEEFNH	L EEF NH SP
LEEFU	L EEFU SP
LEER	L EER SP
LEEX	L EEX SP
LEEJ	L EEJ SP
LEEJCH	L EEJ CH SP
LEEJNH	L EEJ NH SP
LIRNH	L IR NH SP
LIJA	L IJA SP
LIJCH	L IJ CH SP
LIJM	L IJ M SP
LIJNH	L IJ NH SP
LOJ	L OJ SP
LOJC	L OJ C SP
LOJNG	L OJ NG SP
LOJT	L OJ T SP
LORI	L ORI SP
LORN	L OR N SP
LORNG	L OR NG SP
LOOS	L OOS SP
LOOSC	L OOS C SP
LOOSI	L OOSI SP
LOOSM	L OOS M SP
LOOSP	L OOS P SP
LOOST	L OOS T SP
LOOF	L OOF SP
LOOFI	L OOFI SP
LOOFM	L OOF M SP
LOOFNG	L OOF NG SP
LOORM	L OOR M SP
LOORNG	L OOR NG SP
LOOX	L OOX SP
LOOXI	L OOXI SP
LOOJ	L OOJ SP
LOOJC	L OOJ C SP
LOOJI	L OOJI SP
LOOJN	L OOJ N SP
LOOJNG	L OOJ NG SP
LOOJP	L OOJ P SP
LOOJT	L OOJ T SP
LOWSN	L OWS N SP
LOWSP	L OWS P SP
LOWST	L OWS T SP
LOWF	L OWF SP
LOWFI	L OWFI SP
LOWFM	L OWF M SP
LOWFN	L OWF N SP
LOWR	L OWR SP
LOWRI	L OWRI SP
LOWRN	L OWR N SP
LOWX	L OWX SP
LOWXM	L OWX M SP
LOWJI	L OWJI SP
LOWJM	L OWJ M SP
LOWJN	L OWJ N SP
LOWJP	L OWJ P SP
LUJ	L UJ SP
LUJA	L UJA SP
LUJC	L UJ C SP
LUJNG	L UJ NG SP
LUJT	L UJ T SP
LUR	L UR SP
LURI	L URI SP
LURM	L UR M SP
LURNG	L UR NG SP
LUWSA	L UWSA SP
LUWSC	L UWS C SP
LUWST	L UWS T SP
LUWF	L UWF SP
LUWFA	L UWFA SP
LUWFNG	L UWF NG SP
LUWR	L UWR SP
LUWRA	L UWRA SP
LUWRNG	L UWR NG SP
LUWX	L UWX SP
LUWXA	L UWXA SP
LUWXNG	L UWX NG SP
LUWJA	L UWJA SP
LUWJC	L UWJ C SP
LUWJU	L UWJU SP
LYJ	L YJ SP
M	M  SP
MA	M A SP
MAI	M AI SP
MAN	M A N SP
MANG	M A NG SP
MANH	M A NH SP
MAU	M AU SP
MAY	M AY SP
ME	M E SP
MEN	M E N SP
MI	M I SP
MIN	M I N SP
MINH	M I NH SP
MIEEN	M IEE N SP
MIEEU	M IEEU SP
MIEESNG	M IEES NG SP
MIEEST	M IEES T SP
MIEESU	M IEESU SP
MIEEFN	M IEEF N SP
MIEEFU	M IEEFU SP
MIEEXN	M IEEX N SP
MIEEJN	M IEEJ N SP
MIEEJNG	M IEEJ NG SP
MIEEJT	M IEEJ T SP
MO	M O SP
MONG	M O NG SP
MU	M U SP
MUA	M UA SP
MUN	M U N SP
MUOON	M UOO N SP
MUOONG	M UOO NG SP
MUOOSI	M UOOSI SP
MUOOSN	M UOOS N SP
MUOOSNG	M UOOS NG SP
MUOOST	M UOOS T SP
MUOOFI	M UOOFI SP
MUOOXI	M UOOXI SP
MUOOXM	M UOOX M SP
MUOOXNG	M UOOX NG SP
MUOOJN	M UOOJ N SP
MY	M Y SP
MAF	M AF SP
MAFI	M AFI SP
MAFN	M AF N SP
MAFNG	M AF NG SP
MAFNH	M AF NH SP
MAFO	M AFO SP
MAFU	M AFU SP
MAFY	M AFY SP
MAS	M AS SP
MASC	M AS C SP
MASCH	M AS CH SP
MASI	M ASI SP
MASN	M AS N SP
MASNG	M AS NG SP
MASNH	M AS NH SP
MASO	M ASO SP
MAST	M AS T SP
MASU	M ASU SP
MASY	M ASY SP
MAAM	M AA M SP
MAAN	M AA N SP
MAAU	M AAU SP
MAAY	M AAY SP
MAX	M AX SP
MAXI	M AXI SP
MAXN	M AX N SP
MAXNG	M AX NG SP
MAXNH	M AX NH SP
MEF	M EF SP
MEFN	M EF N SP
MEFO	M EFO SP
MES	M ES SP
MESM	M ES M SP
MESN	M ES N SP
MESO	M ESO SP
MESP	M ES P SP
MEST	M ES T SP
MEE	M EE SP
MEENH	M EE NH SP
MIF	M IF SP
MIFN	M IF N SP
MIFNH	M IF NH SP
MIS	M IS SP
MISA	M ISA SP
MISP	M IS P SP
MIST	M IS T SP
MISU	M ISU SP
MOF	M OF SP
MOFI	M OFI SP
MOFN	M OF N SP
MOFNG	M OF NG SP
MOS	M OS SP
MOSC	M OS C SP
MOSI	M OSI SP
MOSM	M OS M SP
MOSN	M OS N SP
MOSNG	M OS NG SP
MOSP	M OS P SP
MOST	M OS T SP
MOO	M OO SP
MOOI	M OOI SP
MOON	M OO N SP
MOONG	M OO NG SP
MOX	M OX SP
MOXM	M OX M SP
MUF	M UF SP
MUFA	M UFA SP
MUFI	M UFI SP
MUFN	M UF N SP
MUFNG	M UF NG SP
MUS	M US SP
MUSA	M USA SP
MUSI	M USI SP
MUSN	M US N SP
MUSP	M US P SP
MUST	M US T SP
MAWM	M AW M SP
MAWN	M AW N SP
MAWNG	M AW NG SP
MIXM	M IX M SP
MUX	M UX SP
MUXI	M UXI SP
MUXM	M UX M SP
MOW	M OW SP
MOWN	M OW N SP
MUWA	M UWA SP
MUWU	M UWU SP
MUWOWI	M UWOWI SP
MUWOWNG	M UWOW NG SP
MUWOWSN	M UWOWS N SP
MUWOWSP	M UWOWS P SP
MUWOWST	M UWOWS T SP
MUWOWFI	M UWOWFI SP
MUWOWFNG	M UWOWF NG SP
MUWOWJN	M UWOWJ N SP
MUWOWJT	M UWOWJ T SP
MAJ	M AJ SP
MAJC	M AJ C SP
MAJCH	M AJ CH SP
MAJI	M AJI SP
MAJN	M AJ N SP
MAJNG	M AJ NG SP
MAJNH	M AJ NH SP
MAJO	M AJO SP
MAJP	M AJ P SP
MAJT	M AJ T SP
MAJY	M AJY SP
MAR	M AR SP
MARI	M ARI SP
MARNG	M AR NG SP
MARNH	M AR NH SP
MAASN	M AAS N SP
MAAST	M AAS T SP
MAASU	M AASU SP
MAASY	M AASY SP
MAAFM	M AAF M SP
MAAFN	M AAF N SP
MAAFU	M AAFU SP
MAARN	M AAR N SP
MAARU	M AARU SP
MAARY	M AARY SP
MAAXN	M AAX N SP
MAAXU	M AAXU SP
MAAJN	M AAJ N SP
MAAJP	M AAJ P SP
MAAJT	M AAJ T SP
MAAJU	M AAJU SP
MAWSC	M AWS C SP
MAWSM	M AWS M SP
MAWSN	M AWS N SP
MAWSNG	M AWS NG SP
MAWST	M AWS T SP
MAWFN	M AWF N SP
MAWRN	M AWR N SP
MAWJC	M AWJ C SP
MAWJN	M AWJ N SP
MAWJT	M AWJ T SP
MEJ	M EJ SP
MEJO	M EJO SP
MEJT	M EJ T SP
MER	M ER SP
MEX	M EX SP
MEESCH	M EES CH SP
MEESN	M EES N SP
MEESU	M EESU SP
MEEF	M EEF SP
MEEFM	M EEF M SP
MEEFN	M EEF N SP
MEEJ	M EEJ SP
MEEJNH	M EEJ NH SP
MEEJT	M EEJ T SP
MIR	M IR SP
MIRA	M IRA SP
MIRM	M IR M SP
MIJ	M IJ SP
MIJN	M IJ N SP
MIJT	M IJ T SP
MOJ	M OJ SP
MOJC	M OJ C SP
MOJI	M OJI SP
MOJN	M OJ N SP
MOJNG	M OJ NG SP
MOJT	M OJ T SP
MOR	M OR SP
MORI	M ORI SP
MORM	M OR M SP
MORNG	M OR NG SP
MOOSC	M OOS C SP
MOOSI	M OOSI SP
MOOST	M OOS T SP
MOOF	M OOF SP
MOOFI	M OOFI SP
MOOFM	M OOF M SP
MOOFNG	M OOF NG SP
MOOR	M OOR SP
MOOX	M OOX SP
MOOXI	M OOXI SP
MOOJ	M OOJ SP
MOOJC	M OOJ C SP
MOOJNG	M OOJ NG SP
MOOJT	M OOJ T SP
MOWS	M OWS SP
MOWSI	M OWSI SP
MOWSP	M OWS P SP
MOWF	M OWF SP
MOWFI	M OWFI SP
MOWR	M OWR SP
MOWRN	M OWR N SP
MOWX	M OWX SP
MOWJ	M OWJ SP
MUJ	M UJ SP
MUJC	M UJ C SP
MUJN	M UJ N SP
MUJP	M UJ P SP
MUR	M UR SP
MURI	M URI SP
MURN	M UR N SP
MUWSC	M UWS C SP
MUWST	M UWS T SP
MUWFNG	M UWF NG SP
MUWRA	M UWRA SP
MUWJC	M UWJ C SP
MYX	M YX SP
NA	N A SP
NAI	N AI SP
NAM	N A M SP
NAN	N A N SP
NANG	N A NG SP
NANH	N A NH SP
NAO	N AO SP
NAY	N AY SP
NEM	N E M SP
NEO	N EO SP
NGA	NG A SP
NGAI	NG AI SP
NGAN	NG A N SP
NGANG	NG A NG SP
NGAO	NG AO SP
NGAY	NG AY SP
NGHE	NGH E SP
NGHI	NGH I SP
NGHIEEM	NGH IEE M SP
NGHIEEN	NGH IEE N SP
NGHIEENG	NGH IEE NG SP
NGHIEESN	NGH IEES N SP
NGHIEEFN	NGH IEEF N SP
NGHIEEJM	NGH IEEJ M SP
NGHIEEJN	NGH IEEJ N SP
NGHIEEJP	NGH IEEJ P SP
NGHIEEJT	NGH IEEJ T SP
NGHEF	NGH EF SP
NGHEFO	NGH EFO SP
NGHES	NGH ES SP
NGHEE	NGH EE SP
NGHEENH	NGH EE NH SP
NGHEEU	NGH EEU SP
NGHIFN	NGH IF N SP
NGHIX	NGH IX SP
NGHIXA	NGH IXA SP
NGHIXNH	NGH IX NH SP
NGHEJN	NGH EJ N SP
NGHEJO	NGH EJO SP
NGHEJT	NGH EJ T SP
NGHERO	NGH ERO SP
NGHEXN	NGH EX N SP
NGHEESCH	NGH EES CH SP
NGHEEF	NGH EEF SP
NGHEEJ	NGH EEJ SP
NGHIR	NGH IR SP
NGHIRU	NGH IRU SP
NGHIJ	NGH IJ SP
NGHIJCH	NGH IJ CH SP
NGOA	NG OA SP
NGOAN	NG OA N SP
NGOANG	NG OA NG SP
NGOAY	NG OAY SP
NGOE	NG OE SP
NGOI	NG OI SP
NGON	NG O N SP
NGOAFI	NG OAFI SP
NGOAFM	NG OAF M SP
NGOASC	NG OAS C SP
NGOASCH	NG OAS CH SP
NGOASI	NG OASI SP
NGOASO	NG OASO SP
NGOASY	NG OASY SP
NGOAXN	NG OAX N SP
NGOEFO	NG OEFO SP
NGOESO	NG OESO SP
NGOAJI	NG OAJI SP
NGOAJN	NG OAJ N SP
NGOARNH	NG OAR NH SP
NGOAWSC	NG OAWS C SP
NGOAWST	NG OAWS T SP
NGOAWFN	NG OAWF N SP
NGOAWFNG	NG OAWF NG SP
NGOAWXNG	NG OAWX NG SP
NGOAWJC	NG OAWJ C SP
NGOAWJT	NG OAWJ T SP
NGU	NG U SP
NGUY	NG UY SP
NGUYEEN	NG UYEE N SP
NGUYEEFN	NG UYEEF N SP
NGUYEEXN	NG UYEEX N SP
NGUYEEJN	NG UYEEJ N SP
NGUYEEJT	NG UYEEJ T SP
NGUAARY	NG UAARY SP
NGUOOFI	NG UOOFI SP
NGUOOFN	NG UOOF N SP
NGUOOJI	NG UOOJI SP
NGAF	NG AF SP
NGAFI	NG AFI SP
NGAFM	NG AF M SP
NGAFN	NG AF N SP
NGAFNG	NG AF NG SP
NGAFNH	NG AF NH SP
NGAFO	NG AFO SP
NGAFY	NG AFY SP
NGASCH	NG AS CH SP
NGASN	NG AS N SP
NGASNG	NG AS NG SP
NGASO	NG ASO SP
NGASP	NG AS P SP
NGAST	NG AS T SP
NGASU	NG ASU SP
NGASY	NG ASY SP
NGAAM	NG AA M SP
NGAAN	NG AA N SP
NGAAY	NG AAY SP
NGAX	NG AX SP
NGAXI	NG AXI SP
NGISA	NG ISA SP
NGOF	NG OF SP
NGOFI	NG OFI SP
NGOS	NG OS SP
NGOSC	NG OS C SP
NGOSE	NG OSE SP
NGOSI	NG OSI SP
NGOSN	NG OS N SP
NGOSNG	NG OS NG SP
NGOST	NG OS T SP
NGOO	NG OO SP
NGOOI	NG OOI SP
NGOON	NG OO N SP
NGOONG	NG OO NG SP
NGOX	NG OX SP
NGUFI	NG UFI SP
NGUSC	NG US C SP
NGUSNG	NG US NG SP
NGUST	NG US T SP
NGAWN	NG AW N SP
NGUX	NG UX SP
NGOW	NG OW SP
NGOWI	NG OWI SP
NGUW	NG UW SP
NGUWA	NG UWA SP
NGUWNG	NG UW NG SP
NGUWU	NG UWU SP
NGUWOWI	NG UWOWI SP
NGUWOWSC	NG UWOWS C SP
NGUWOWFI	NG UWOWFI SP
NGUWOWRNG	NG UWOWR NG SP
NGUWOWXNG	NG UWOWX NG SP
NGUWOWJC	NG UWOWJ C SP
NGUWOWJNG	NG UWOWJ NG SP
NGAJC	NG AJ C SP
NGAJI	NG AJI SP
NGAJN	NG AJ N SP
NGAJO	NG AJO SP
NGAJT	NG AJ T SP
NGAR	NG AR SP
NGARI	NG ARI SP
NGARNH	NG AR NH SP
NGAAST	NG AAS T SP
NGAASU	NG AASU SP
NGAASY	NG AASY SP
NGAAFM	NG AAF M SP
NGAAFN	NG AAF N SP
NGAAFY	NG AAFY SP
NGAARM	NG AAR M SP
NGAARN	NG AAR N SP
NGAARNG	NG AAR NG SP
NGAAXM	NG AAX M SP
NGAAXU	NG AAXU SP
NGAAJM	NG AAJ M SP
NGAAJP	NG AAJ P SP
NGAAJU	NG AAJU SP
NGAAJY	NG AAJY SP
NGAWSC	NG AWS C SP
NGAWSM	NG AWS M SP
NGAWSN	NG AWS N SP
NGAWST	NG AWS T SP
NGAWXNG	NG AWX NG SP
NGAWJT	NG AWJ T SP
NGOJ	NG OJ SP
NGOJC	NG OJ C SP
NGOJN	NG OJ N SP
NGOJNG	NG OJ NG SP
NGOJT	NG OJ T SP
NGOR	NG OR SP
NGOOSC	NG OOS C SP
NGOOFI	NG OOFI SP
NGOOFM	NG OOF M SP
NGOOFN	NG OOF N SP
NGOOR	NG OOR SP
NGOORM	NG OOR M SP
NGOOX	NG OOX SP
NGOOJ	NG OOJ SP
NGOOJN	NG OOJ N SP
NGOOJT	NG OOJ T SP
NGOWSN	NG OWS N SP
NGOWST	NG OWS T SP
NGOWF	NG OWF SP
NGOWX	NG OWX SP
NGOWJ	NG OWJ SP
NGOWJI	NG OWJI SP
NGOWJM	NG OWJ M SP
NGOWJP	NG OWJ P SP
NGUJ	NG UJ SP
NGUJA	NG UJA SP
NGUJC	NG UJ C SP
NGUJM	NG UJ M SP
NGUJP	NG UJ P SP
NGUR	NG UR SP
NGURI	NG URI SP
NGURN	NG UR N SP
NGUWS	NG UWS SP
NGUWSA	NG UWSA SP
NGUWFA	NG UWFA SP
NGUWFNG	NG UWF NG SP
NGUWRI	NG UWRI SP
NGUWRNG	NG UWR NG SP
NGUWX	NG UWX SP
NGUWJ	NG UWJ SP
NGUWJA	NG UWJA SP
NGUWJC	NG UWJ C SP
NHA	NH A SP
NHAI	NH AI SP
NHAM	NH A M SP
NHAN	NH A N SP
NHANG	NH A NG SP
NHANH	NH A NH SP
NHAO	NH AO SP
NHAU	NH AU SP
NHAY	NH AY SP
NHE	NH E SP
NHEM	NH E M SP
NHEN	NH E N SP
NHEO	NH EO SP
NHI	NH I SP
NHIEEN	NH IEE N SP
NHIEEU	NH IEEU SP
NHIEESC	NH IEES C SP
NHIEESP	NH IEES P SP
NHIEEFU	NH IEEFU SP
NHIEEXM	NH IEEX M SP
NHIEEXU	NH IEEXU SP
NHIEEJM	NH IEEJ M SP
NHIEEJT	NH IEEJ T SP
NHO	NH O SP
NHOAI	NH OAI SP
NHOE	NH OE SP
NHOEN	NH OE N SP
NHOM	NH O M SP
NHONG	NH O NG SP
NHOAFI	NH OAFI SP
NHOASNG	NH OAS NG SP
NHOEST	NH OES T SP
NHOERN	NH OER N SP
NHU	NH U SP
NHUNG	NH U NG SP
NHUYEEXN	NH UYEEX N SP
NHUAAFN	NH UAAF N SP
NHUAAJN	NH UAAJ N SP
NHUEEJ	NH UEEJ SP
NHUOOSM	NH UOOS M SP
NHUOOJM	NH UOOJ M SP
NHAF	NH AF SP
NHAFI	NH AFI SP
NHAFM	NH AF M SP
NHAFN	NH AF N SP
NHAFNG	NH AF NG SP
NHAFNH	NH AF NH SP
NHAFO	NH AFO SP
NHAFU	NH AFU SP
NHAS	NH AS SP
NHASC	NH AS C SP
NHASNG	NH AS NG SP
NHASNH	NH AS NH SP
NHASO	NH ASO SP
NHAST	NH AS T SP
NHASY	NH ASY SP
NHAAM	NH AA M SP
NHAAN	NH AA N SP
NHAX	NH AX SP
NHAXI	NH AXI SP
NHAXN	NH AX N SP
NHAXO	NH AXO SP
NHEF	NH EF SP
NHEFM	NH EF M SP
NHES	NH ES SP
NHESP	NH ES P SP
NHEST	NH ES T SP
NHIF	NH IF SP
NHIFN	NH IF N SP
NHIS	NH IS SP
NHISCH	NH IS CH SP
NHISM	NH IS M SP
NHIST	NH IS T SP
NHISU	NH ISU SP
NHOFE	NH OFE SP
NHOFM	NH OF M SP
NHOSC	NH OS C SP
NHOSI	NH OSI SP
NHOSM	NH OS M SP
NHOSNG	NH OS NG SP
NHOSP	NH OS P SP
NHOST	NH OS T SP
NHOO	NH OO SP
NHOOM	NH OO M SP
NHOON	NH OO N SP
NHOONG	NH OO NG SP
NHOX	NH OX SP
NHOXM	NH OX M SP
NHOXN	NH OX N SP
NHOXNG	NH OX NG SP
NHUF	NH UF SP
NHUFI	NH UFI SP
NHUFNG	NH UF NG SP
NHUS	NH US SP
NHUSA	NH USA SP
NHUSC	NH US C SP
NHUSN	NH US N SP
NHUSNG	NH US NG SP
NHUST	NH US T SP
NHAWM	NH AW M SP
NHAWN	NH AW N SP
NHAWNG	NH AW NG SP
NHIX	NH IX SP
NHUX	NH UX SP
NHUXNG	NH UX NG SP
NHOWI	NH OWI SP
NHOWN	NH OW N SP
NHUW	NH UW SP
NHUWNG	NH UW NG SP
NHUWOWSNG	NH UWOWS NG SP
NHUWOWFNG	NH UWOWF NG SP
NHUWOWXNG	NH UWOWX NG SP
NHUWOWJC	NH UWOWJ C SP
NHUWOWJNG	NH UWOWJ NG SP
NHAJC	NH AJ C SP
NHAJI	NH AJI SP
NHAJNH	NH AJ NH SP
NHAJO	NH AJO SP
NHAJT	NH AJ T SP
NHAJY	NH AJY SP
NHAR	NH AR SP
NHARI	NH ARI SP
NHARM	NH AR M SP
NHARNH	NH AR NH SP
NHARY	NH ARY SP
NHAASC	NH AAS C SP
NHAASM	NH AAS M SP
NHAASN	NH AAS N SP
NHAASP	NH AAS P SP
NHAAST	NH AAS T SP
NHAAFM	NH AAF M SP
NHAAFY	NH AAFY SP
NHAARM	NH AAR M SP
NHAAXN	NH AAX N SP
NHAAXY	NH AAXY SP
NHAAJM	NH AAJ M SP
NHAAJN	NH AAJ N SP
NHAAJP	NH AAJ P SP
NHAAJT	NH AAJ T SP
NHAAJU	NH AAJU SP
NHAWSC	NH AWS C SP
NHAWSM	NH AWS M SP
NHAWSN	NH AWS N SP
NHAWST	NH AWS T SP
NHAWFM	NH AWF M SP
NHAWFN	NH AWF N SP
NHAWFNG	NH AWF NG SP
NHAWXN	NH AWX N SP
NHAWJM	NH AWJ M SP
NHAWJNG	NH AWJ NG SP
NHAWJT	NH AWJ T SP
NHEJ	NH EJ SP
NHEJM	NH EJ M SP
NHEJP	NH EJ P SP
NHERM	NH ER M SP
NHEXO	NH EXO SP
NHEESCH	NH EES CH SP
NHEEJN	NH EEJ N SP
NHEEJU	NH EEJU SP
NHIR	NH IR SP
NHIRNH	NH IR NH SP
NHIJ	NH IJ SP
NHIJN	NH IJ N SP
NHIJP	NH IJ P SP
NHOJC	NH OJ C SP
NHOJN	NH OJ N SP
NHOJT	NH OJ T SP
NHOR	NH OR SP
NHORM	NH OR M SP
NHOOS	NH OOS SP
NHOOSI	NH OOSI SP
NHOOST	NH OOS T SP
NHOOFI	NH OOFI SP
NHOOFN	NH OOF N SP
NHOORM	NH OOR M SP
NHOORN	NH OOR N SP
NHOOJN	NH OOJ N SP
NHOOJT	NH OOJ T SP
NHOWS	NH OWS SP
NHOWSP	NH OWS P SP
NHOWF	NH OWF SP
NHOWFN	NH OWF N SP
NHOWR	NH OWR SP
NHOWJT	NH OWJ T SP
NHUJA	NH UJA SP
NHUJC	NH UJ C SP
NHUJY	NH UJY SP
NHUR	NH UR SP
NHURN	NH UR N SP
NHUWS	NH UWS SP
NHUWSC	NH UWS C SP
NHUWXNG	NH UWX NG SP
NHUWJA	NH UWJA SP
NHUWJT	NH UWJ T SP
NI	N I SP
NIA	N IA SP
NIN	N I N SP
NINH	N I NH SP
NIU	N IU SP
NIEEM	N IEE M SP
NIEEN	N IEE N SP
NIEEU	N IEEU SP
NIEEST	N IEES T SP
NIEEFM	N IEEF M SP
NIEEFNG	N IEEF NG SP
NIEEJM	N IEEJ M SP
NIEEJU	N IEEJU SP
NO	N O SP
NOM	N O M SP
NON	N O N SP
NONG	N O NG SP
NUA	N UA SP
NUNG	N U NG SP
NUOOI	N UOOI SP
NUOONG	N UOO NG SP
NUOOSI	N UOOSI SP
NUOOST	N UOOS T SP
NAF	N AF SP
NAFN	N AF N SP
NAFNG	N AF NG SP
NAFNH	N AF NH SP
NAFO	N AFO SP
NAFY	N AFY SP
NAS	N AS SP
NASCH	N AS CH SP
NASM	N AS M SP
NASN	N AS N SP
NASO	N ASO SP
NAST	N AS T SP
NASU	N ASU SP
NASY	N ASY SP
NAANG	N AA NG SP
NAAU	N AAU SP
NAAY	N AAY SP
NAXO	N AXO SP
NAXY	N AXY SP
NEF	N EF SP
NEFO	N EFO SP
NES	N ES SP
NESM	N ES M SP
NESN	N ES N SP
NESO	N ESO SP
NESP	N ES P SP
NEST	N ES T SP
NEE	N EE SP
NEEM	N EE M SP
NEEN	N EE N SP
NEEU	N EEU SP
NIF	N IF SP
NIFNH	N IF NH SP
NISCH	N IS CH SP
NISN	N IS N SP
NISNH	N IS NH SP
NIST	N IS T SP
NISU	N ISU SP
NOS	N OS SP
NOSC	N OS C SP
NOSI	N OSI SP
NOSN	N OS N SP
NOSNG	N OS NG SP
NOST	N OS T SP
NOO	N OO SP
NOOI	N OOI SP
NOOM	N OO M SP
NOON	N OO N SP
NOONG	N OO NG SP
NOXN	N OX N SP
NUFN	N UF N SP
NUFNG	N UF NG SP
NUSC	N US C SP
NUSI	N USI SP
NUSM	N US M SP
NUSNG	N US NG SP
NUSP	N US P SP
NUST	N US T SP
NAWM	N AW M SP
NAWN	N AW N SP
NAWNG	N AW NG SP
NIXA	N IXA SP
NUXNG	N UX NG SP
NOWI	N OWI SP
NOWM	N OW M SP
NUW	N UW SP
NUWOWNG	N UWOW NG SP
NUWOWSC	N UWOWS C SP
NUWOWSNG	N UWOWS NG SP
NAJ	N AJ SP
NAJC	N AJ C SP
NAJI	N AJI SP
NAJN	N AJ N SP
NAJNH	N AJ NH SP
NAJO	N AJO SP
NAJP	N AJ P SP
NAJT	N AJ T SP
NAR	N AR SP
NARN	N AR N SP
NARY	N ARY SP
NAASC	N AAS C SP
NAASM	N AAS M SP
NAASNG	N AAS NG SP
NAASU	N AASU SP
NAASY	N AASY SP
NAAFN	N AAF N SP
NAAFY	N AAFY SP
NAAJM	N AAJ M SP
NAAJP	N AAJ P SP
NAAJU	N AAJU SP
NAWSC	N AWS C SP
NAWSM	N AWS M SP
NAWSN	N AWS N SP
NAWSNG	N AWS NG SP
NAWSP	N AWS P SP
NAWFM	N AWF M SP
NAWFN	N AWF N SP
NAWFNG	N AWF NG SP
NAWXNG	N AWX NG SP
NAWJC	N AWJ C SP
NAWJNG	N AWJ NG SP
NEJP	N EJ P SP
NER	N ER SP
NERO	N ERO SP
NEESM	N EES M SP
NEESN	N EES N SP
NEESP	N EES P SP
NEEST	N EES T SP
NEESU	N EESU SP
NEEF	N EEF SP
NEEFN	N EEF N SP
NEER	N EER SP
NEEJ	N EEJ SP
NEEJM	N EEJ M SP
NIR	N IR SP
NIJCH	N IJ CH SP
NIJNH	N IJ NH SP
NIJU	N IJU SP
NOJ	N OJ SP
NOJC	N OJ C SP
NOJNG	N OJ NG SP
NOJT	N OJ T SP
NOR	N OR SP
NOOS	N OOS SP
NOOSC	N OOS C SP
NOOSI	N OOSI SP
NOOSNG	N OOS NG SP
NOOST	N OOS T SP
NOOF	N OOF SP
NOOFI	N OOFI SP
NOOFM	N OOF M SP
NOOFNG	N OOF NG SP
NOOR	N OOR SP
NOORI	N OORI SP
NOOX	N OOX SP
NOOXI	N OOXI SP
NOOJ	N OOJ SP
NOOJC	N OOJ C SP
NOOJI	N OOJI SP
NOOJN	N OOJ N SP
NOOJP	N OOJ P SP
NOWS	N OWS SP
NOWSI	N OWSI SP
NOWSP	N OWS P SP
NOWST	N OWS T SP
NOWR	N OWR SP
NOWX	N OWX SP
NOWJ	N OWJ SP
NUJ	N UJ SP
NUWSC	N UWS C SP
NUWST	N UWS T SP
NUWRA	N UWRA SP
NUWX	N UWX SP
NUWXA	N UWXA SP
NUWJ	N UWJ SP
NUWJC	N UWJ C SP
O	O SP
OAI	OAI SP
OAN	OA N SP
OANH	OA NH SP
OE	OE SP
OI	OI SP
OM	O M SP
ONG	O NG SP
OAFNH	OAF NH SP
OASCH	OAS CH SP
OASI	OASI SP
OASN	OAS N SP
OAWM	OAW M SP
OAJP	OAJ P SP
OARI	OARI SP
OAWST	OAWS T SP
OAWFN	OAWF N SP
PA	P A SP
PHA	PH A SP
PHAN	PH A N SP
PHANH	PH A NH SP
PHAO	PH AO SP
PHE	PH E SP
PHI	PH I SP
PHIM	PH I M SP
PHIEEN	PH IEE N SP
PHIEEU	PH IEEU SP
PHIEESM	PH IEES M SP
PHIEEST	PH IEES T SP
PHIEESU	PH IEESU SP
PHIEEFN	PH IEEF N SP
PHIEEJN	PH IEEJ N SP
PHO	PH O SP
PHONG	PH O NG SP
PHU	PH U SP
PHUN	PH U N SP
PHUNG	PH U NG SP
PHUY	PH UY SP
PHAFM	PH AF M SP
PHAFN	PH AF N SP
PHAFO	PH AFO SP
PHAS	PH AS SP
PHASC	PH AS C SP
PHASCH	PH AS CH SP
PHASI	PH ASI SP
PHASN	PH AS N SP
PHASO	PH ASO SP
PHASP	PH AS P SP
PHAST	PH AS T SP
PHAAN	PH AA N SP
PHAAY	PH AAY SP
PHEF	PH EF SP
PHEFN	PH EF N SP
PHEFO	PH EFO SP
PHESNG	PH ES NG SP
PHESP	PH ES P SP
PHEST	PH ES T SP
PHEE	PH EE SP
PHIF	PH IF SP
PHIFNH	PH IF NH SP
PHIS	PH IS SP
PHISA	PH ISA SP
PHISCH	PH IS CH SP
PHISM	PH IS M SP
PHISNH	PH IS NH SP
PHOF	PH OF SP
PHOFI	PH OFI SP
PHOFNG	PH OF NG SP
PHOS	PH OS SP
PHOSC	PH OS C SP
PHOSNG	PH OS NG SP
PHOST	PH OS T SP
PHOO	PH OO SP
PHUF	PH UF SP
PHUFNG	PH UF NG SP
PHUS	PH US SP
PHUSC	PH US C SP
PHUSNG	PH US NG SP
PHUST	PH US T SP
PHAWNG	PH AW NG SP
PHIXNH	PH IX NH SP
PHOW	PH OW SP
PHOWI	PH OWI SP
PHOWN	PH OW N SP
PHUWOWNG	PH UWOW NG SP
PHUWOWSC	PH UWOWS C SP
PHUWOWSN	PH UWOWS N SP
PHUWOWFNG	PH UWOWF NG SP
PHUWOWJNG	PH UWOWJ NG SP
PHAJC	PH AJ C SP
PHAJM	PH AJ M SP
PHAJNG	PH AJ NG SP
PHAJT	PH AJ T SP
PHAR	PH AR SP
PHARI	PH ARI SP
PHARN	PH AR N SP
PHARY	PH ARY SP
PHAASN	PH AAS N SP
PHAAST	PH AAS T SP
PHAAFM	PH AAF M SP
PHAAFN	PH AAF N SP
PHAARM	PH AAR M SP
PHAARY	PH AARY SP
PHAAXN	PH AAX N SP
PHAAXU	PH AAXU SP
PHAAJN	PH AAJ N SP
PHAAJT	PH AAJ T SP
PHAWSC	PH AWS C SP
PHAWRNG	PH AWR NG SP
PHEES	PH EES SP
PHEESCH	PH EES CH SP
PHEEST	PH EES T SP
PHEEF	PH EEF SP
PHEEFU	PH EEFU SP
PHEEXU	PH EEXU SP
PHEEJ	PH EEJ SP
PHEEJNH	PH EEJ NH SP
PHIR	PH IR SP
PHIRNH	PH IR NH SP
PHIJCH	PH IJ CH SP
PHOJT	PH OJ T SP
PHORNG	PH OR NG SP
PHOOS	PH OOS SP
PHOOSC	PH OOS C SP
PHOOSI	PH OOSI SP
PHOOFM	PH OOF M SP
PHOOFNG	PH OOF NG SP
PHOOR	PH OOR SP
PHOORI	PH OORI SP
PHOORNG	PH OOR NG SP
PHOOXNG	PH OOX NG SP
PHOOJNG	PH OOJ NG SP
PHOWSI	PH OWSI SP
PHOWST	PH OWS T SP
PHOWF	PH OWF SP
PHOWR	PH OWR SP
PHOWXN	PH OWX N SP
PHUJ	PH UJ SP
PHUJC	PH UJ C SP
PHUJNG	PH UJ NG SP
PHUR	PH UR SP
PHURI	PH URI SP
PHUWSC	PH UWS C SP
PIN	P I N SP
PIEEU	P IEEU SP
PIS	P IS SP
QUA	QU A SP
QUAI	QU AI SP
QUAN	QU A N SP
QUANG	QU A NG SP
QUANH	QU A NH SP
QUAY	QU AY SP
QUE	QU E SP
QUEN	QU E N SP
QUEO	QU EO SP
QUI	QU I SP
QUOAJNG	QU OAJ NG SP
QUY	QU Y SP
QUYEEN	QU YEE N SP
QUYEESN	QU YEES N SP
QUYEEST	QU YEES T SP
QUYEEFN	QU YEEF N SP
QUYEERN	QU YEER N SP
QUYEEJN	QU YEEJ N SP
QUYEEJT	QU YEEJ T SP
QUAF	QU AF SP
QUAFI	QU AFI SP
QUAFNG	QU AF NG SP
QUAFY	QU AFY SP
QUAS	QU AS SP
QUASC	QU AS C SP
QUASCH	QU AS CH SP
QUASI	QU ASI SP
QUASN	QU AS N SP
QUASNG	QU AS NG SP
QUASNH	QU AS NH SP
QUAST	QU AS T SP
QUAAN	QU AA N SP
QUAAY	QU AAY SP
QUAXNG	QU AX NG SP
QUEF	QU EF SP
QUEFN	QU EF N SP
QUEST	QU ES T SP
QUEE	QU EE SP
QUEEN	QU EE N SP
QUIF	QU IF SP
QUIS	QU IS SP
QUIST	QU IS T SP
QUYS	QU YS SP
QUYSNH	QU YS NH SP
QUYST	QU YS T SP
QUAWM	QU AW M SP
QUAWNG	QU AW NG SP
QUIX	QU IX SP
QUAJC	QU AJ C SP
QUAJCH	QU AJ CH SP
QUAJI	QU AJI SP
QUAJNG	QU AJ NG SP
QUAJNH	QU AJ NH SP
QUAJT	QU AJ T SP
QUAR	QU AR SP
QUARI	QU ARI SP
QUARN	QU AR N SP
QUARNG	QU AR NG SP
QUARY	QU ARY SP
QUAASN	QU AAS N SP
QUAAST	QU AAS T SP
QUAASY	QU AASY SP
QUAAFN	QU AAF N SP
QUAAFNG	QU AAF NG SP
QUAAFY	QU AAFY SP
QUAARN	QU AAR N SP
QUAAXN	QU AAX N SP
QUAAXY	QU AAXY SP
QUAAJN	QU AAJ N SP
QUAAJT	QU AAJ T SP
QUAAJY	QU AAJY SP
QUAWSC	QU AWS C SP
QUAWSN	QU AWS N SP
QUAWFN	QU AWF N SP
QUAWRNG	QU AWR NG SP
QUAWJC	QU AWJ C SP
QUAWJM	QU AWJ M SP
QUAWJN	QU AWJ N SP
QUAWJT	QU AWJ T SP
QUEJO	QU EJO SP
QUEES	QU EES SP
QUEEST	QU EES T SP
QUEEFNH	QU EEF NH SP
QUEEJ	QU EEJ SP
QUEEJNH	QU EEJ NH SP
QUIR	QU IR SP
QUIJ	QU IJ SP
QUOOSC	QU OOS C SP
QUOWSI	QU OWSI SP
QUOWF	QU OWF SP
QUOWFN	QU OWF N SP
QUYF	QU YF SP
QUYFNH	QU YF NH SP
QUYJ	QU YJ SP
QUYJT	QU YJ T SP
QUYR	QU YR SP
QUYX	QU YX SP
RA	R A SP
RAI	R AI SP
RAM	R A M SP
RAN	R A N SP
RANG	R A NG SP
RANH	R A NH SP
RAO	R AO SP
RAU	R AU SP
RAY	R AY SP
RE	R E SP
REN	R E N SP
REO	R EO SP
RI	R I SP
RIA	R IA SP
RINH	R I NH SP
RIU	R IU SP
RIEENG	R IEE NG SP
RIEEU	R IEEU SP
RIEESP	R IEES P SP
RIEEST	R IEES T SP
RIEEJT	R IEEJ T SP
RO	R O SP
ROI	R OI SP
ROM	R O M SP
RONG	R O NG SP
RU	R U SP
RUA	R UA SP
RUN	R U N SP
RUNG	R U NG SP
RUOOSC	R UOOS C SP
RUOOFI	R UOOFI SP
RUOORI	R UOORI SP
RUOOXNG	R UOOX NG SP
RUOOJNG	R UOOJ NG SP
RUOOJT	R UOOJ T SP
RAF	R AF SP
RAFNG	R AF NG SP
RAFNH	R AF NH SP
RAFO	R AFO SP
RAFY	R AFY SP
RASC	R AS C SP
RASCH	R AS CH SP
RASI	R ASI SP
RASN	R AS N SP
RASNG	R AS NG SP
RASO	R ASO SP
RASP	R AS P SP
RAST	R AS T SP
RASY	R ASY SP
RAAM	R AA M SP
RAAN	R AA N SP
RAAU	R AAU SP
RAX	R AX SP
RAXI	R AXI SP
RAXY	R AXY SP
REFM	R EF M SP
REFN	R EF N SP
REFO	R EFO SP
RESN	R ES N SP
RESO	R ESO SP
REST	R ES T SP
REE	R EE SP
REEN	R EE N SP
REEU	R EEU SP
RIF	R IF SP
RIFA	R IFA SP
RIFNH	R IF NH SP
RIST	R IS T SP
RISU	R ISU SP
ROFI	R OFI SP
ROFM	R OF M SP
ROFNG	R OF NG SP
ROS	R OS SP
ROSC	R OS C SP
ROSI	R OSI SP
ROSN	R OS N SP
ROST	R OS T SP
ROO	R OO SP
ROX	R OX SP
RUFA	R UFA SP
RUFM	R UF M SP
RUS	R US SP
RUSC	R US C SP
RUSM	R US M SP
RUSNG	R US NG SP
RUST	R US T SP
RAWN	R AW N SP
RAWNG	R AW NG SP
RIX	R IX SP
RUX	R UX SP
ROW	R OW SP
ROWI	R OWI SP
ROWM	R OW M SP
ROWN	R OW N SP
RUWNG	R UW NG SP
RUWOWI	R UWOWI SP
RUWOWSC	R UWOWS C SP
RUWOWSI	R UWOWSI SP
RUWOWSM	R UWOWS M SP
RUWOWFI	R UWOWFI SP
RUWOWRI	R UWOWRI SP
RUWOWXI	R UWOWXI SP
RUWOWJI	R UWOWJI SP
RUWOWJT	R UWOWJ T SP
RUWOWJU	R UWOWJU SP
RAJ	R AJ SP
RAJCH	R AJ CH SP
RAJN	R AJ N SP
RAJNG	R AJ NG SP
RAJO	R AJO SP
RAJP	R AJ P SP
RAJT	R AJ T SP
RAR	R AR SP
RARI	R ARI SP
RARNH	R AR NH SP
RARO	R ARO SP
RAASN	R AAS N SP
RAASP	R AAS P SP
RAAST	R AAS T SP
RAAFM	R AAF M SP
RAAFN	R AAF N SP
RAAFU	R AAFU SP
RAAFY	R AAFY SP
RAARY	R AARY SP
RAAXY	R AAXY SP
RAAJN	R AAJ N SP
RAAJP	R AAJ P SP
RAAJT	R AAJ T SP
RAWSC	R AWS C SP
RAWSM	R AWS M SP
RAWSN	R AWS N SP
RAWFM	R AWF M SP
RAWFNG	R AWF NG SP
RAWJNG	R AWJ NG SP
REJO	R EJO SP
REJT	R EJ T SP
RER	R ER SP
REX	R EX SP
REES	R EES SP
REESN	R EES N SP
REEST	R EES T SP
REEF	R EEF SP
REER	R EER SP
REEX	R EEX SP
REEJ	R EEJ SP
REEJT	R EEJ T SP
REEJU	R EEJU SP
RIR	R IR SP
RIRA	R IRA SP
RIRNH	R IR NH SP
RIJA	R IJA SP
RIJCH	R IJ CH SP
RIJN	R IJ N SP
RIJT	R IJ T SP
ROJI	R OJI SP
RORI	R ORI SP
ROOSC	R OOS C SP
ROOSI	R OOSI SP
ROOSN	R OOS N SP
ROOSNG	R OOS NG SP
ROOSP	R OOS P SP
ROOST	R OOS T SP
ROOF	R OOF SP
ROOFI	R OOFI SP
ROOFNG	R OOF NG SP
ROOR	R OOR SP
ROOXI	R OOXI SP
ROOXNG	R OOX NG SP
ROOJ	R OOJ SP
ROOJC	R OOJ C SP
ROOJN	R OOJ N SP
ROOJNG	R OOJ NG SP
ROOJP	R OOJ P SP
ROWSM	R OWS M SP
ROWST	R OWS T SP
ROWF	R OWF SP
ROWFI	R OWFI SP
ROWFN	R OWF N SP
ROWX	R OWX SP
ROWXN	R OWX N SP
ROWJ	R OWJ SP
ROWJI	R OWJI SP
ROWJN	R OWJ N SP
ROWJP	R OWJ P SP
RUJC	R UJ C SP
RUJNG	R UJ NG SP
RUR	R UR SP
RURA	R URA SP
RURI	R URI SP
RURNG	R UR NG SP
RUWSC	R UWS C SP
RUWST	R UWS T SP
RUWFNG	R UWF NG SP
RUWRA	R UWRA SP
RUWXA	R UWXA SP
RUWJA	R UWJA SP
RUWJC	R UWJ C SP
SA	S A SP
SAI	S AI SP
SAM	S A M SP
SAN	S A N SP
SANG	S A NG SP
SANH	S A NH SP
SAO	S AO SP
SAU	S AU SP
SAY	S AY SP
SE	S E SP
SEN	S E N SP
SI	S I SP
SIM	S I M SP
SINH	S I NH SP
SIEEU	S IEEU SP
SIEEST	S IEES T SP
SO	S O SP
SOI	S OI SP
SON	S O N SP
SONG	S O NG SP
SOAST	S OAS T SP
SOAJN	S OAJ N SP
SOAJNG	S OAJ NG SP
SOAJT	S OAJ T SP
SU	S U SP
SUM	S U M SP
SUN	S U N SP
SUNG	S U NG SP
SUY	S UY SP
SUYEERN	S UYEER N SP
SUYEEXN	S UYEEX N SP
SUYST	S UYS T SP
SUAAST	S UAAS T SP
SUOOSI	S UOOSI SP
SUOOST	S UOOS T SP
SAF	S AF SP
SAFI	S AFI SP
SAFM	S AF M SP
SAFN	S AF N SP
SAFNG	S AF NG SP
SAFNH	S AF NH SP
SAFO	S AFO SP
SAS	S AS SP
SASC	S AS C SP
SASCH	S AS CH SP
SASI	S ASI SP
SASNG	S AS NG SP
SASNH	S AS NH SP
SASO	S ASO SP
SASP	S AS P SP
SAST	S AS T SP
SASU	S ASU SP
SAAM	S AA M SP
SAAN	S AA N SP
SAAU	S AAU SP
SAXI	S AXI SP
SEFO	S EFO SP
SESC	S ES C SP
SEST	S ES T SP
SEEN	S EE N SP
SEENH	S EE NH SP
SEEU	S EEU SP
SIF	S IF SP
SISNH	S IS NH SP
SOF	S OF SP
SOFNG	S OF NG SP
SOSC	S OS C SP
SOSI	S OSI SP
SOSN	S OS N SP
SOSNG	S OS NG SP
SOST	S OS T SP
SOO	S OO SP
SOOI	S OOI SP
SOONG	S OO NG SP
SOXI	S OXI SP
SUFI	S UFI SP
SUS	S US SP
SUSC	S US C SP
SUSNG	S US NG SP
SUSP	S US P SP
SUST	S US T SP
SUSY	S USY SP
SAWN	S AW N SP
SIX	S IX SP
SUXNG	S UX NG SP
SOW	S OW SP
SOWM	S OW M SP
SOWN	S OW N SP
SUW	S UW SP
SUWA	S UWA SP
SUWNG	S UW NG SP
SUWU	S UWU SP
SUWOWNG	S UWOW NG SP
SUWOWSNG	S UWOWS NG SP
SUWOWST	S UWOWS T SP
SUWOWFN	S UWOWF N SP
SUWOWFNG	S UWOWF NG SP
SUWOWRI	S UWOWRI SP
SUWOWJT	S UWOWJ T SP
SAJCH	S AJ CH SP
SAJM	S AJ M SP
SAJN	S AJ N SP
SAJO	S AJO SP
SAJP	S AJ P SP
SAJT	S AJ T SP
SARN	S AR N SP
SARNG	S AR NG SP
SARNH	S AR NH SP
SARO	S ARO SP
SARY	S ARY SP
SAASM	S AAS M SP
SAASU	S AASU SP
SAASY	S AASY SP
SAAFM	S AAF M SP
SAAFN	S AAF N SP
SAAFU	S AAFU SP
SAARN	S AAR N SP
SAARY	S AARY SP
SAAXM	S AAX M SP
SAAJP	S AAJ P SP
SAWSC	S AWS C SP
SAWSM	S AWS M SP
SAWSN	S AWS N SP
SAWSNG	S AWS NG SP
SAWSP	S AWS P SP
SAWST	S AWS T SP
SAWXN	S AWX N SP
SAWJC	S AWJ C SP
SEJM	S EJ M SP
SEJO	S EJO SP
SER	S ER SP
SERN	S ER N SP
SEX	S EX SP
SEESP	S EES P SP
SEESU	S EESU SP
SEEFN	S EEF N SP
SEER	S EER SP
SEERNH	S EER NH SP
SEEX	S EEX SP
SEEJT	S EEJ T SP
SIJT	S IJ T SP
SOJ	S OJ SP
SOJM	S OJ M SP
SOJT	S OJ T SP
SOR	S OR SP
SORI	S ORI SP
SOOS	S OOS SP
SOOSC	S OOS C SP
SOOSNG	S OOS NG SP
SOOST	S OOS T SP
SOOF	S OOF SP
SOOFI	S OOFI SP
SOOFN	S OOF N SP
SOOR	S OOR SP
SOOX	S OOX SP
SOOJ	S OOJ SP
SOOJT	S OOJ T SP
SOWS	S OWS SP
SOWSI	S OWSI SP
SOWSM	S OWS M SP
SOWSN	S OWS N SP
SOWST	S OWS T SP
SOWF	S OWF SP
SOWFM	S OWF M SP
SOWFN	S OWF N SP
SOWR	S OWR SP
SOWX	S OWX SP
SOWJ	S OWJ SP
SOWJI	S OWJI SP
SUJA	S UJA SP
SUJC	S UJ C SP
SUJN	S UJ N SP
SUJT	S UJ T SP
SURA	S URA SP
SURI	S URI SP
SUWS	S UWS SP
SUWSA	S UWSA SP
SUWSC	S UWS C SP
SUWST	S UWS T SP
SUWFNG	S UWF NG SP
SUWR	S UWR SP
SUWRA	S UWRA SP
SUWRNG	S UWR NG SP
SUWXA	S UWXA SP
SUWXNG	S UWX NG SP
SUWJ	S UWJ SP
SUWJC	S UWJ C SP
SYX	S YX SP
T	T  SP
TA	T A SP
TAI	T AI SP
TAM	T A M SP
TAN	T A N SP
TANG	T A NG SP
TANH	T A NH SP
TAO	T AO SP
TAY	T AY SP
TEM	T E M SP
TEN	T E N SP
TEO	T EO SP
THA	TH A SP
THAI	TH AI SP
THAM	TH A M SP
THAN	TH A N SP
THANG	TH A NG SP
THANH	TH A NH SP
THAO	TH AO SP
THAY	TH AY SP
THE	TH E SP
THEN	TH E N SP
THEO	TH EO SP
THI	TH I SP
THIA	TH IA SP
THIN	TH I N SP
THINH	TH I NH SP
THIEEM	TH IEE M SP
THIEEN	TH IEE N SP
THIEENG	TH IEE NG SP
THIEESC	TH IEES C SP
THIEESP	TH IEES P SP
THIEEST	TH IEES T SP
THIEESU	TH IEESU SP
THIEEFM	TH IEEF M SP
THIEEFN	TH IEEF N SP
THIEEFU	TH IEEFU SP
THIEERN	TH IEER N SP
THIEERU	TH IEERU SP
THIEEJN	TH IEEJ N SP
THIEEJP	TH IEEJ P SP
THIEEJT	TH IEEJ T SP
THIEEJU	TH IEEJU SP
THO	TH O SP
THOA	TH OA SP
THOANG	TH OA NG SP
THOI	TH OI SP
THON	TH O N SP
THONG	TH O NG SP
THOASI	TH OASI SP
THOASNG	TH OAS NG SP
THOAST	TH OAS T SP
THOAWN	TH OAW N SP
THOAJI	TH OAJI SP
THOAJT	TH OAJ T SP
THOAR	TH OAR SP
THOARI	TH OARI SP
THOARNG	TH OAR NG SP
THOAWST	TH OAWS T SP
THU	TH U SP
THUA	TH UA SP
THUI	TH UI SP
THUN	TH U N SP
THUNG	TH U NG SP
THUYEEN	TH UYEE N SP
THUYEEST	TH UYEES T SP
THUYEEFN	TH UYEEF N SP
THUEE	TH UEE SP
THUAAFN	TH UAAF N SP
THUAAXN	TH UAAX N SP
THUAAJN	TH UAAJ N SP
THUAAJT	TH UAAJ T SP
THUEES	TH UEES SP
THUOOSC	TH UOOS C SP
THUOOFNG	TH UOOF NG SP
THUOOJC	TH UOOJ C SP
THUOWR	TH UOWR SP
THUYR	TH UYR SP
THAF	TH AF SP
THAFI	TH AFI SP
THAFNH	TH AF NH SP
THAFO	TH AFO SP
THASC	TH AS C SP
THASCH	TH AS CH SP
THASI	TH ASI SP
THASM	TH AS M SP
THASN	TH AS N SP
THASNG	TH AS NG SP
THASNH	TH AS NH SP
THASO	TH ASO SP
THASP	TH AS P SP
THAAM	TH AA M SP
THAAN	TH AA N SP
THAAU	TH AAU SP
THAAY	TH AAY SP
THAXI	TH AXI SP
THEFM	TH EF M SP
THEFO	TH EFO SP
THESP	TH ES P SP
THEST	TH ES T SP
THEE	TH EE SP
THEEM	TH EE M SP
THEENH	TH EE NH SP
THEEU	TH EEU SP
THIF	TH IF SP
THIFA	TH IFA SP
THIFNH	TH IF NH SP
THIFU	TH IFU SP
THIS	TH IS SP
THISA	TH ISA SP
THISCH	TH IS CH SP
THISM	TH IS M SP
THISN	TH IS N SP
THISNH	TH IS NH SP
THISP	TH IS P SP
THIST	TH IS T SP
THOF	TH OF SP
THOFI	TH OFI SP
THOFNG	TH OF NG SP
THOS	TH OS SP
THOSA	TH OSA SP
THOSC	TH OS C SP
THOSI	TH OSI SP
THOSP	TH OS P SP
THOST	TH OS T SP
THOO	TH OO SP
THOOI	TH OOI SP
THOON	TH OO N SP
THOONG	TH OO NG SP
THOXNG	TH OX NG SP
THUF	TH UF SP
THUFM	TH UF M SP
THUFNG	TH UF NG SP
THUFY	TH UFY SP
THUS	TH US SP
THUSC	TH US C SP
THUSNG	TH US NG SP
THUST	TH US T SP
THUSY	TH USY SP
THAWM	TH AW M SP
THAWNG	TH AW NG SP
THUXNG	TH UX NG SP
THOW	TH OW SP
THOWI	TH OWI SP
THOWM	TH OW M SP
THUW	TH UW SP
THUWA	TH UWA SP
THUWOWNG	TH UWOW NG SP
THUWOWSC	TH UWOWS C SP
THUWOWFNG	TH UWOWF NG SP
THUWOWRNG	TH UWOWR NG SP
THUWOWXI	TH UWOWXI SP
THUWOWXN	TH UWOWX N SP
THUWOWJC	TH UWOWJ C SP
THUWOWJNG	TH UWOWJ NG SP
THAJC	TH AJ C SP
THAJCH	TH AJ CH SP
THAJNH	TH AJ NH SP
THAJO	TH AJO SP
THAR	TH AR SP
THARI	TH ARI SP
THARM	TH AR M SP
THARN	TH AR N SP
THARNG	TH AR NG SP
THARNH	TH AR NH SP
THARO	TH ARO SP
THARY	TH ARY SP
THAASM	TH AAS M SP
THAASP	TH AAS P SP
THAAST	TH AAS T SP
THAASU	TH AASU SP
THAASY	TH AASY SP
THAAFM	TH AAF M SP
THAAFN	TH AAF N SP
THAAFU	TH AAFU SP
THAAFY	TH AAFY SP
THAARM	TH AAR M SP
THAARN	TH AAR N SP
THAAXM	TH AAX M SP
THAAXN	TH AAX N SP
THAAJM	TH AAJ M SP
THAAJN	TH AAJ N SP
THAAJP	TH AAJ P SP
THAAJT	TH AAJ T SP
THAWSC	TH AWS C SP
THAWSN	TH AWS N SP
THAWSNG	TH AWS NG SP
THAWSP	TH AWS P SP
THAWST	TH AWS T SP
THAWFN	TH AWF N SP
THAWFNG	TH AWF NG SP
THAWRM	TH AWR M SP
THAWRNG	TH AWR NG SP
THER	TH ER SP
THEES	TH EES SP
THEESCH	TH EES CH SP
THEESP	TH EES P SP
THEEF	TH EEF SP
THEEFM	TH EEF M SP
THEEFU	TH EEFU SP
THEER	TH EER SP
THEEJ	TH EEJ SP
THIR	TH IR SP
THIRNH	TH IR NH SP
THIJ	TH IJ SP
THIJCH	TH IJ CH SP
THIJNH	TH IJ NH SP
THIJT	TH IJ T SP
THIJU	TH IJU SP
THOJ	TH OJ SP
THOJC	TH OJ C SP
THOJT	TH OJ T SP
THOR	TH OR SP
THORA	TH ORA SP
THORI	TH ORI SP
THORM	TH OR M SP
THOOS	TH OOS SP
THOOSI	TH OOSI SP
THOOSN	TH OOS N SP
THOOSNG	TH OOS NG SP
THOOST	TH OOS T SP
THOOF	TH OOF SP
THOOFI	TH OOFI SP
THOOFN	TH OOF N SP
THOOR	TH OOR SP
THOORI	TH OORI SP
THOWSI	TH OWSI SP
THOWST	TH OWS T SP
THOWF	TH OWF SP
THOWFI	TH OWFI SP
THOWR	TH OWR SP
THOWJ	TH OWJ SP
THUJ	TH UJ SP
THUJC	TH UJ C SP
THUJNG	TH UJ NG SP
THUJP	TH UJ P SP
THUJT	TH UJ T SP
THUJY	TH UJY SP
THUR	TH UR SP
THURA	TH URA SP
THURI	TH URI SP
THURNG	TH UR NG SP
THURY	TH URY SP
THUWS	TH UWS SP
THUWSC	TH UWS C SP
THUWF	TH UWF SP
THUWFA	TH UWFA SP
THUWFNG	TH UWF NG SP
THUWR	TH UWR SP
THUWRA	TH UWRA SP
THUWXNG	TH UWX NG SP
THUWJ	TH UWJ SP
THUWJC	TH UWJ C SP
TI	T I SP
TIA	T IA SP
TIM	T I M SP
TIN	T I N SP
TINH	T I NH SP
TIU	T IU SP
TIEEM	T IEE M SP
TIEEN	T IEE N SP
TIEEU	T IEEU SP
TIEESC	T IEES C SP
TIEESM	T IEES M SP
TIEESN	T IEES N SP
TIEESNG	T IEES NG SP
TIEESP	T IEES P SP
TIEEST	T IEES T SP
TIEESU	T IEESU SP
TIEEFM	T IEEF M SP
TIEEFN	T IEEF N SP
TIEERU	T IEERU SP
TIEEXN	T IEEX N SP
TIEEXU	T IEEXU SP
TIEEJC	T IEEJ C SP
TIEEJM	T IEEJ M SP
TIEEJN	T IEEJ N SP
TO	T O SP
TOA	T OA SP
TOAN	T OA N SP
TOANH	T OA NH SP
TOE	T OE SP
TONG	T O NG SP
TOP	T O P SP
TOAF	T OAF SP
TOAFI	T OAFI SP
TOAFN	T OAF N SP
TOASI	T OASI SP
TOASN	T OAS N SP
TOAST	T OAS T SP
TOEST	T OES T SP
TOAJC	T OAJ C SP
TOAR	T OAR SP
TOARN	T OAR N SP
TOEJT	T OEJ T SP
TRA	TR A SP
TRAI	TR AI SP
TRANG	TR A NG SP
TRANH	TR A NH SP
TRAO	TR AO SP
TRAU	TR AU SP
TRE	TR E SP
TREO	TR EO SP
TRI	TR I SP
TRINH	TR I NH SP
TRIEENG	TR IEE NG SP
TRIEEST	TR IEES T SP
TRIEEFN	TR IEEF N SP
TRIEEFNG	TR IEEF NG SP
TRIEEFU	TR IEEFU SP
TRIEERN	TR IEER N SP
TRIEEJNG	TR IEEJ NG SP
TRIEEJT	TR IEEJ T SP
TRIEEJU	TR IEEJU SP
TRO	TR O SP
TRONG	TR O NG SP
TRU	TR U SP
TRUNG	TR U NG SP
TRUY	TR UY SP
TRUYEEFN	TR UYEEF N SP
TRUYEEJN	TR UYEEJ N SP
TRUAAN	TR UAA N SP
TRUAAJT	TR UAAJ T SP
TRUOOFNG	TR UOOF NG SP
TRAF	TR AF SP
TRAFI	TR AFI SP
TRAFM	TR AF M SP
TRAFN	TR AF N SP
TRAFNG	TR AF NG SP
TRAFNH	TR AF NH SP
TRAFO	TR AFO SP
TRAS	TR AS SP
TRASCH	TR AS CH SP
TRASI	TR ASI SP
TRASM	TR AS M SP
TRASN	TR AS N SP
TRASNG	TR AS NG SP
TRASNH	TR AS NH SP
TRASO	TR ASO SP
TRASP	TR AS P SP
TRAST	TR AS T SP
TRAAM	TR AA M SP
TRAAN	TR AA N SP
TRAAU	TR AAU SP
TRAX	TR AX SP
TRAXI	TR AXI SP
TREFO	TR EFO SP
TRESM	TR ES M SP
TRESO	TR ESO SP
TREE	TR EE SP
TREEN	TR EE N SP
TREEU	TR EEU SP
TRIF	TR IF SP
TRIFNH	TR IF NH SP
TRIFU	TR IFU SP
TRIS	TR IS SP
TRISCH	TR IS CH SP
TROF	TR OF SP
TROFN	TR OF N SP
TROFNG	TR OF NG SP
TROSC	TR OS C SP
TROSNG	TR OS NG SP
TROST	TR OS T SP
TROOI	TR OOI SP
TROOM	TR OO M SP
TROONG	TR OO NG SP
TROXN	TR OX N SP
TRUF	TR UF SP
TRUFI	TR UFI SP
TRUFM	TR UF M SP
TRUFN	TR UF N SP
TRUFNG	TR UF NG SP
TRUS	TR US SP
TRUSC	TR US C SP
TRUSM	TR US M SP
TRUSNG	TR US NG SP
TRUST	TR US T SP
TRAWM	TR AW M SP
TRAWN	TR AW N SP
TRAWNG	TR AW NG SP
TRIX	TR IX SP
TRIXU	TR IXU SP
TRUXNG	TR UX NG SP
TROW	TR OW SP
TROWI	TR OWI SP
TROWN	TR OW N SP
TRUW	TR UW SP
TRUWA	TR UWA SP
TRUWNG	TR UW NG SP
TRUWOWNG	TR UWOW NG SP
TRUWOWSC	TR UWOWS C SP
TRUWOWSNG	TR UWOWS NG SP
TRUWOWFNG	TR UWOWF NG SP
TRUWOWRNG	TR UWOWR NG SP
TRUWOWXNG	TR UWOWX NG SP
TRUWOWJT	TR UWOWJ T SP
TRAJC	TR AJ C SP
TRAJI	TR AJI SP
TRAJM	TR AJ M SP
TRAJNG	TR AJ NG SP
TRAR	TR AR SP
TRARI	TR ARI SP
TRARO	TR ARO SP
TRARU	TR ARU SP
TRAASN	TR AAS N SP
TRAASU	TR AASU SP
TRAAFM	TR AAF M SP
TRAAFN	TR AAF N SP
TRAAFU	TR AAFU SP
TRAAFY	TR AAFY SP
TRAAXM	TR AAX M SP
TRAAJN	TR AAJ N SP
TRAAJT	TR AAJ T SP
TRAWSC	TR AWS C SP
TRAWSNG	TR AWS NG SP
TRAWFN	TR AWF N SP
TRAWJC	TR AWJ C SP
TRAWJN	TR AWJ N SP
TREJO	TR EJO SP
TRER	TR ER SP
TREXN	TR EX N SP
TREESCH	TR EES CH SP
TREEF	TR EEF SP
TREEX	TR EEX SP
TREEJ	TR EEJ SP
TREEJT	TR EEJ T SP
TRIJ	TR IJ SP
TRIJA	TR IJA SP
TRIJCH	TR IJ CH SP
TRIJNH	TR IJ NH SP
TRIJT	TR IJ T SP
TROJ	TR OJ SP
TROJC	TR OJ C SP
TROJI	TR OJI SP
TROJN	TR OJ N SP
TROJNG	TR OJ NG SP
TROJT	TR OJ T SP
TROR	TR OR SP
TROOSN	TR OOS N SP
TROOSNG	TR OOS NG SP
TROOF	TR OOF SP
TROOFI	TR OOFI SP
TROOFNG	TR OOF NG SP
TROOR	TR OOR SP
TROOJ	TR OOJ SP
TROOJM	TR OOJ M SP
TROOJN	TR OOJ N SP
TROWS	TR OWS SP
TROWSN	TR OWS N SP
TROWF	TR OWF SP
TROWFI	TR OWFI SP
TROWR	TR OWR SP
TROWJ	TR OWJ SP
TROWJN	TR OWJ N SP
TROWJT	TR OWJ T SP
TRUJ	TR UJ SP
TRUJA	TR UJA SP
TRUJC	TR UJ C SP
TRUJI	TR UJI SP
TRUJT	TR UJ T SP
TRUJY	TR UJY SP
TRUWS	TR UWS SP
TRUWSNG	TR UWS NG SP
TRUWF	TR UWF SP
TRUWFNG	TR UWF NG SP
TRUWRNG	TR UWR NG SP
TRUWX	TR UWX SP
TRUWJC	TR UWJ C SP
TU	T U SP
TUA	T UA SP
TUI	T UI SP
TUM	T U M SP
TUNG	T U NG SP
TUY	T UY SP
TUYEEN	T UYEE N SP
TUYEESN	T UYEES N SP
TUYEEST	T UYEES T SP
TUYEEFN	T UYEEF N SP
TUYEERN	T UYEER N SP
TUYEEJT	T UYEEJ T SP
TUAAN	T UAA N SP
TUOON	T UOO N SP
TUOONG	T UOO NG SP
TUAASN	T UAAS N SP
TUAAFN	T UAAF N SP
TUEES	T UEES SP
TUEEJ	T UEEJ SP
TUEEJCH	T UEEJ CH SP
TUOOST	T UOOS T SP
TUOOFN	T UOOF N SP
TUOOFNG	T UOOF NG SP
TUOORI	T UOORI SP
TUOOJT	T UOOJ T SP
TUYF	T UYF SP
TY	T Y SP
TAF	T AF SP
TAFI	T AFI SP
TAFN	T AF N SP
TAFNG	T AF NG SP
TAFNH	T AF NH SP
TAFO	T AFO SP
TAFU	T AFU SP
TAFY	T AFY SP
TAS	T AS SP
TASC	T AS C SP
TASCH	T AS CH SP
TASI	T ASI SP
TASM	T AS M SP
TASN	T AS N SP
TASNG	T AS NG SP
TASNH	T AS NH SP
TASO	T ASO SP
TASP	T AS P SP
TAST	T AS T SP
TASY	T ASY SP
TAAM	T AA M SP
TAAN	T AA N SP
TAAY	T AAY SP
TAX	T AX SP
TAXI	T AXI SP
TEF	T EF SP
TEFN	T EF N SP
TES	T ES SP
TESC	T ES C SP
TESM	T ES M SP
TESN	T ES N SP
TESP	T ES P SP
TEST	T ES T SP
TEE	T EE SP
TEEN	T EE N SP
TIF	T IF SP
TIFM	T IF M SP
TIFNH	T IF NH SP
TIS	T IS SP
TISA	T ISA SP
TISCH	T IS CH SP
TISM	T IS M SP
TISN	T IS N SP
TISNH	T IS NH SP
TISP	T IS P SP
TIST	T IS T SP
TISU	T ISU SP
TOF	T OF SP
TOFA	T OFA SP
TOFE	T OFE SP
TOFI	T OFI SP
TOFM	T OF M SP
TOFNG	T OF NG SP
TOSC	T OS C SP
TOSE	T OSE SP
TOSM	T OS M SP
TOSP	T OS P SP
TOO	T OO SP
TOOI	T OOI SP
TOOM	T OO M SP
TOON	T OO N SP
TOONG	T OO NG SP
TUF	T UF SP
TUFNG	T UF NG SP
TUFY	T UFY SP
TUS	T US SP
TUSC	T US C SP
TUSI	T USI SP
TUSM	T US M SP
TUSNG	T US NG SP
TUST	T US T SP
TUSY	T USY SP
TYS	T YS SP
TAWM	T AW M SP
TAWN	T AW N SP
TAWNG	T AW NG SP
TIXNH	T IX NH SP
TUXM	T UX M SP
TOW	T OW SP
TOWI	T OWI SP
TUW	T UW SP
TUWA	T UWA SP
TUWNG	T UW NG SP
TUWOWI	T UWOWI SP
TUWOWM	T UWOW M SP
TUWOWNG	T UWOW NG SP
TUWOWSC	T UWOWS C SP
TUWOWSI	T UWOWSI SP
TUWOWSNG	T UWOWS NG SP
TUWOWFM	T UWOWF M SP
TUWOWFNG	T UWOWF NG SP
TUWOWFU	T UWOWFU SP
TUWOWRI	T UWOWRI SP
TUWOWRNG	T UWOWR NG SP
TUWOWJNG	T UWOWJ NG SP
TUWOWJP	T UWOWJ P SP
TAJ	T AJ SP
TAJCH	T AJ CH SP
TAJI	T AJI SP
TAJM	T AJ M SP
TAJNG	T AJ NG SP
TAJO	T AJO SP
TAJP	T AJ P SP
TAJT	T AJ T SP
TAR	T AR SP
TARI	T ARI SP
TARN	T AR N SP
TARNG	T AR NG SP
TARO	T ARO SP
TAASC	T AAS C SP
TAASM	T AAS M SP
TAASN	T AAS N SP
TAASP	T AAS P SP
TAAST	T AAS T SP
TAASU	T AASU SP
TAASY	T AASY SP
TAAFM	T AAF M SP
TAAFN	T AAF N SP
TAAFNG	T AAF NG SP
TAAFY	T AAFY SP
TAARM	T AAR M SP
TAARN	T AAR N SP
TAARY	T AARY SP
TAAJM	T AAJ M SP
TAAJN	T AAJ N SP
TAAJP	T AAJ P SP
TAAJT	T AAJ T SP
TAWSC	T AWS C SP
TAWSM	T AWS M SP
TAWSN	T AWS N SP
TAWST	T AWS T SP
TAWFM	T AWF M SP
TAWRN	T AWR N SP
TAWJC	T AWJ C SP
TAWJNG	T AWJ NG SP
TEJO	T EJO SP
TEJP	T EJ P SP
TER	T ER SP
TEES	T EES SP
TEEST	T EES T SP
TEESU	T EESU SP
TEER	T EER SP
TEEX	T EEX SP
TEEXNH	T EEX NH SP
TEEJ	T EEJ SP
TEEJP	T EEJ P SP
TIR	T IR SP
TIRA	T IRA SP
TIRM	T IR M SP
TIRNH	T IR NH SP
TIJ	T IJ SP
TIJCH	T IJ CH SP
TIJNH	T IJ NH SP
TOJA	T OJA SP
TOJC	T OJ C SP
TOJP	T OJ P SP
TOR	T OR SP
TORA	T ORA SP
TORI	T ORI SP
TOOS	T OOS SP
TOOSC	T OOS C SP
TOOSI	T OOSI SP
TOOSN	T OOS N SP
TOOSNG	T OOS NG SP
TOOSP	T OOS P SP
TOOST	T OOS T SP
TOOFI	T OOFI SP
TOOFN	T OOF N SP
TOOR	T OOR SP
TOORN	T OOR N SP
TOORNG	T OOR NG SP
TOOJC	T OOJ C SP
TOOJI	T OOJI SP
TOOJT	T OOJ T SP
TOWS	T OWS SP
TOWSI	T OWSI SP
TOWSN	T OWS N SP
TOWF	T OWF SP
TOWRM	T OWR M SP
TOWJ	T OWJ SP
TOWJP	T OWJ P SP
TUJ	T UJ SP
TUJC	T UJ C SP
TUJI	T UJI SP
TUJM	T UJ M SP
TUJNG	T UJ NG SP
TUJT	T UJ T SP
TUJY	T UJY SP
TUR	T UR SP
TURI	T URI SP
TURM	T UR M SP
TURN	T UR N SP
TURY	T URY SP
TUWS	T UWS SP
TUWSC	T UWS C SP
TUWF	T UWF SP
TUWFNG	T UWF NG SP
TUWR	T UWR SP
TUWRA	T UWRA SP
TUWRU	T UWRU SP
TUWJ	T UWJ SP
TUWJA	T UWJA SP
TUWJU	T UWJU SP
TYJ	T YJ SP
TYR	T YR SP
U	U SP
UNG	U NG SP
UY	UY SP
UYEEN	UYEE N SP
UYEERN	UYEER N SP
UAAST	UAAS T SP
UEES	UEES SP
UEER	UEER SP
UOOSN	UOOS N SP
UOOSNG	UOOS NG SP
UOOJT	UOOJ T SP
UYJCH	UYJ CH SP
UYR	UYR SP
V	V  SP
VA	V A SP
VAI	V AI SP
VAN	V A N SP
VANG	V A NG SP
VANH	V A NH SP
VAO	V AO SP
VAY	V AY SP
VE	V E SP
VEN	V E N SP
VEO	V EO SP
VI	V I SP
VINH	V I NH SP
VIEEM	V IEE M SP
VIEEN	V IEE N SP
VIEESNG	V IEES NG SP
VIEEST	V IEES T SP
VIEEFN	V IEEF N SP
VIEERN	V IEER N SP
VIEEXN	V IEEX N SP
VIEEJC	V IEEJ C SP
VIEEJN	V IEEJ N SP
VIEEJT	V IEEJ T SP
VO	V O SP
VOI	V OI SP
VON	V O N SP
VONG	V O NG SP
VU	V U SP
VUA	V UA SP
VUI	V UI SP
VUN	V U N SP
VUNG	V U NG SP
VUOONG	V UOO NG SP
VUOOST	V UOOS T SP
VUOOJT	V UOOJ T SP
VY	V Y SP
VAF	V AF SP
VAFI	V AFI SP
VAFN	V AF N SP
VAFNG	V AF NG SP
VAFNH	V AF NH SP
VAFO	V AFO SP
VAFY	V AFY SP
VAS	V AS SP
VASC	V AS C SP
VASCH	V AS CH SP
VASI	V ASI SP
VASN	V AS N SP
VASNG	V AS NG SP
VASNH	V AS NH SP
VAST	V AS T SP
VASY	V ASY SP
VAAN	V AA N SP
VAANG	V AA NG SP
VAAY	V AAY SP
VAX	V AX SP
VAXI	V AXI SP
VAXNH	V AX NH SP
VEFO	V EFO SP
VES	V ES SP
VESN	V ES N SP
VEST	V ES T SP
VEE	V EE SP
VEEN	V EE N SP
VEENH	V EE NH SP
VIF	V IF SP
VIS	V IS SP
VISA	V ISA SP
VIST	V IS T SP
VISU	V ISU SP
VOF	V OF SP
VOFI	V OFI SP
VOFM	V OF M SP
VOFNG	V OF NG SP
VOS	V OS SP
VOSC	V OS C SP
VOST	V OS T SP
VOO	V OO SP
VOOI	V OOI SP
VOONG	V OO NG SP
VOX	V OX SP
VOXNG	V OX NG SP
VUF	V UF SP
VUFI	V UFI SP
VUFN	V UF N SP
VUFNG	V UF NG SP
VUS	V US SP
VUST	V US T SP
VAWN	V AW N SP
VAWNG	V AW NG SP
VIX	V IX SP
VIXNH	V IX NH SP
VUX	V UX SP
VUXNG	V UX NG SP
VOW	V OW SP
VUWOWN	V UWOW N SP
VUWOWNG	V UWOW NG SP
VUWOWSNG	V UWOWS NG SP
VUWOWFN	V UWOWF N SP
VUWOWRNG	V UWOWR NG SP
VUWOWJNG	V UWOWJ NG SP
VUWOWJT	V UWOWJ T SP
VAJ	V AJ SP
VAJC	V AJ C SP
VAJCH	V AJ CH SP
VAJM	V AJ M SP
VAJN	V AJ N SP
VAJT	V AJ T SP
VAR	V AR SP
VARI	V ARI SP
VARNG	V AR NG SP
VARY	V ARY SP
VAASN	V AAS N SP
VAASP	V AAS P SP
VAAST	V AAS T SP
VAASU	V AASU SP
VAASY	V AASY SP
VAAFN	V AAF N SP
VAAFNG	V AAF NG SP
VAAFY	V AAFY SP
VAARN	V AAR N SP
VAARY	V AARY SP
VAAXN	V AAX N SP
VAAXY	V AAXY SP
VAAJN	V AAJ N SP
VAAJT	V AAJ T SP
VAAJY	V AAJY SP
VAWSC	V AWS C SP
VAWSN	V AWS N SP
VAWSNG	V AWS NG SP
VAWST	V AWS T SP
VAWFN	V AWF N SP
VAWFNG	V AWF NG SP
VAWRNG	V AWR NG SP
VAWJC	V AWJ C SP
VAWJN	V AWJ N SP
VAWJT	V AWJ T SP
VEJN	V EJ N SP
VEJO	V EJO SP
VEJT	V EJ T SP
VER	V ER SP
VEX	V EX SP
VEES	V EES SP
VEESCH	V EES CH SP
VEEST	V EES T SP
VEEF	V EEF SP
VEEJ	V EEJ SP
VEEJN	V EEJ N SP
VEEJT	V EEJ T SP
VIR	V IR SP
VIRA	V IRA SP
VIJ	V IJ SP
VIJM	V IJ M SP
VIJN	V IJ N SP
VIJNH	V IJ NH SP
VIJT	V IJ T SP
VOJNG	V OJ NG SP
VOJT	V OJ T SP
VOR	V OR SP
VORN	V OR N SP
VOOSN	V OOS N SP
VOOFNG	V OOF NG SP
VOOX	V OOX SP
VOOJI	V OOJI SP
VOWS	V OWS SP
VOWSI	V OWSI SP
VOWST	V OWS T SP
VOWF	V OWF SP
VOWFI	V OWFI SP
VOWFN	V OWF N SP
VOWR	V OWR SP
VOWRN	V OWR N SP
VOWX	V OWX SP
VOWJ	V OWJ SP
VOWJI	V OWJI SP
VOWJT	V OWJ T SP
VUJ	V UJ SP
VUJN	V UJ N SP
VUJNG	V UJ NG SP
VUJT	V UJ T SP
VUWST	V UWS T SP
VUWFA	V UWFA SP
VUWFNG	V UWF NG SP
VUWRNG	V UWR NG SP
VUWXA	V UWXA SP
VUWXNG	V UWX NG SP
VUWJC	V UWJ C SP
X	X  SP
XA	X A SP
XANG	X A NG SP
XANH	X A NH SP
XAO	X AO SP
XAY	X AY SP
XE	X E SP
XEM	X E M SP
XEN	X E N SP
XEO	X EO SP
XI	X I SP
XIA	X IA SP
XIN	X I N SP
XINH	X I NH SP
XIEEM	X IEE M SP
XIEEU	X IEEU SP
XIEESC	X IEES C SP
XIEEST	X IEES T SP
XOA	X OA SP
XOAN	X OA N SP
XOANG	X OA NG SP
XOAY	X OAY SP
XOE	X OE SP
XOEN	X OE N SP
XOI	X OI SP
XOM	X O M SP
XON	X O N SP
XONG	X O NG SP
XOAFI	X OAFI SP
XOAFN	X OAF N SP
XOAFNG	X OAF NG SP
XOAS	X OAS SP
XOASY	X OASY SP
XOEF	X OEF SP
XOEFN	X OEF N SP
XOEST	X OES T SP
XOAWN	X OAW N SP
XOAJC	X OAJ C SP
XOARNG	X OAR NG SP
XOAWSN	X OAWS N SP
XOEJT	X OEJ T SP
XU	X U SP
XUA	X UA SP
XUI	X UI SP
XUM	X U M SP
XUNG	X U NG SP
XUYEEN	X UYEE N SP
XUYEESN	X UYEES N SP
XUAAN	X UAA N SP
XUEE	X UEE SP
XUOOI	X UOOI SP
XUAAST	X UAAS T SP
XUAARN	X UAAR N SP
XUEER	X UEER SP
XUOOSNG	X UOOS NG SP
XUOOFNG	X UOOF NG SP
XY	X Y SP
XAF	X AF SP
XAFI	X AFI SP
XAFM	X AF M SP
XAFNG	X AF NG SP
XAFO	X AFO SP
XAS	X AS SP
XASC	X AS C SP
XASCH	X AS CH SP
XASM	X AS M SP
XASN	X AS N SP
XASO	X ASO SP
XAST	X AS T SP
XAAM	X AA M SP
XAAU	X AAU SP
XAAY	X AAY SP
XAX	X AX SP
XEF	X EF SP
XEFO	X EFO SP
XES	X ES SP
XEST	X ES T SP
XEE	X EE SP
XEENH	X EE NH SP
XIF	X IF SP
XIFU	X IFU SP
XIS	X IS SP
XISCH	X IS CH SP
XISNH	X IS NH SP
XIST	X IS T SP
XISU	X ISU SP
XOFA	X OFA SP
XOFNG	X OF NG SP
XOS	X OS SP
XOSA	X OSA SP
XOSC	X OS C SP
XOSM	X OS M SP
XOST	X OS T SP
XOO	X OO SP
XOOI	X OOI SP
XOOM	X OO M SP
XOON	X OO N SP
XOONG	X OO NG SP
XOXA	X OXA SP
XUF	X UF SP
XUFM	X UF M SP
XUSC	X US C SP
XUSM	X US M SP
XUSNG	X US NG SP
XAWM	X AW M SP
XAWNG	X AW NG SP
XOW	X OW SP
XOWI	X OWI SP
XUWA	X UWA SP
XUWNG	X UW NG SP
XUWOWNG	X UWOW NG SP
XUWOWSNG	X UWOWS NG SP
XUWOWRNG	X UWOWR NG SP
XAJ	X AJ SP
XAJC	X AJ C SP
XAJCH	X AJ CH SP
XAJO	X AJO SP
XAJP	X AJ P SP
XAR	X AR SP
XARM	X AR M SP
XARO	X ARO SP
XARY	X ARY SP
XAASU	X AASU SP
XAARM	X AAR M SP
XAARY	X AARY SP
XAWSC	X AWS C SP
XAWSN	X AWS N SP
XAWST	X AWS T SP
XAWXNG	X AWX NG SP
XEJO	X EJO SP
XEJP	X EJ P SP
XER	X ER SP
XERNG	X ER NG SP
XEES	X EES SP
XEESCH	X EES CH SP
XEESP	X EES P SP
XEEFNH	X EEF NH SP
XEER	X EER SP
XEEJCH	X EEJ CH SP
XIR	X IR SP
XIRA	X IRA SP
XIRN	X IR N SP
XIRNH	X IR NH SP
XIRU	X IRU SP
XIJ	X IJ SP
XIJT	X IJ T SP
XOJC	X OJ C SP
XOJP	X OJ P SP
XOR	X OR SP
XOOSC	X OOS C SP
XOOSI	X OOSI SP
XOOSN	X OOS N SP
XOOSNG	X OOS NG SP
XOOSP	X OOS P SP
XOOFNG	X OOF NG SP
XOOR	X OOR SP
XOORI	X OORI SP
XOORM	X OOR M SP
XOORNG	X OOR NG SP
XOOJC	X OOJ C SP
XOOJN	X OOJ N SP
XOWSI	X OWSI SP
XOWST	X OWS T SP
XOWR	X OWR SP
XOWRI	X OWRI SP
XOWJT	X OWJ T SP
XUJ	X UJ SP
XUJC	X UJ C SP
XUJI	X UJI SP
XUWS	X UWS SP
XUWSNG	X UWS NG SP
XUWR	X UWR SP
XUWRA	X UWRA SP
XUWRNG	X UWR NG SP
Y	Y SP
YEEN	YEE N SP
YEENG	YEE NG SP
YEEU	YEEU SP
YEESM	YEES M SP
YEESN	YEES N SP
YEESU	YEESU SP
YEERM	YEER M SP
AF	AF SP
AFO	AFO SP
AS	AS SP
ASC	AS C SP
ASCH	AS CH SP
ASI	ASI SP
ASM	AS M SP
ASN	AS N SP
ASNH	AS NH SP
ASO	ASO SP
ASP	AS P SP
AST	AS T SP
ASY	ASY SP
AAM	AA M SP
AAN	AA N SP
AAU	AAU SP
AAY	AAY SP
AX	AX SP
EF	EF SP
EFO	EFO SP
ES	ES SP
ESN	ES N SP
ESO	ESO SP
ESP	ES P SP
EE	EE SP
EEM	EE M SP
IF	IF SP
IS	IS SP
ISCH	IS CH SP
IST	IS T SP
OFA	OFA SP
OFNG	OF NG SP
OSC	OS C SP
OSE	OSE SP
OSI	OSI SP
OSNG	OS NG SP
OO	OO SP
OOI	OOI SP
OOM	OO M SP
OON	OO N SP
OONG	OO NG SP
UF	UF SP
UFA	UFA SP
UFN	UF N SP
US	US SP
USA	USA SP
USM	US M SP
USNG	US NG SP
USP	US P SP
UST	US T SP
USY	USY SP
YS	YS SP
AWM	AW M SP
AWN	AW N SP
DDA	DD A SP
DDAI	DD AI SP
DDAM	DD A M SP
DDAN	DD A N SP
DDANG	DD A NG SP
DDANH	DD A NH SP
DDAO	DD AO SP
DDAU	DD AU SP
DDAY	DD AY SP
DDE	DD E SP
DDEM	DD E M SP
DDEN	DD E N SP
DDEO	DD EO SP
DDI	DD I SP
DDIA	DD IA SP
DDINH	DD I NH SP
DDIEEN	DD IEE N SP
DDIEEU	DD IEEU SP
DDIEESC	DD IEES C SP
DDIEESM	DD IEES M SP
DDIEESU	DD IEESU SP
DDIEEFM	DD IEEF M SP
DDIEEFN	DD IEEF N SP
DDIEEFU	DD IEEFU SP
DDIEERM	DD IEER M SP
DDIEERN	DD IEER N SP
DDIEERU	DD IEERU SP
DDIEEJM	DD IEEJ M SP
DDIEEJN	DD IEEJ N SP
DDIEEJP	DD IEEJ P SP
DDIEEJU	DD IEEJU SP
DDO	DD O SP
DDOAN	DD OA N SP
DDOM	DD O M SP
DDONG	DD O NG SP
DDOAFI	DD OAFI SP
DDOAFN	DD OAF N SP
DDOAFNG	DD OAF NG SP
DDOASN	DD OAS N SP
DDOAJN	DD OAJ N SP
DDOAJT	DD OAJ T SP
DDOARNG	DD OAR NG SP
DDU	DD U SP
DDUA	DD UA SP
DDUI	DD UI SP
DDUN	DD U N SP
DDUNG	DD U NG SP
DDUOOI	DD UOOI SP
DDUOOSC	DD UOOS C SP
DDUOOSI	DD UOOSI SP
DDUOORI	DD UOORI SP
DDUOOJT	DD UOOJ T SP
DDAF	DD AF SP
DDAFI	DD AFI SP
DDAFM	DD AF M SP
DDAFN	DD AF N SP
DDAFNG	DD AF NG SP
DDAFNH	DD AF NH SP
DDAFO	DD AFO SP
DDAS	DD AS SP
DDASC	DD AS C SP
DDASI	DD ASI SP
DDASM	DD AS M SP
DDASNG	DD AS NG SP
DDASNH	DD AS NH SP
DDASO	DD ASO SP
DDASP	DD AS P SP
DDASY	DD ASY SP
DDAAM	DD AA M SP
DDAAU	DD AAU SP
DDAAY	DD AAY SP
DDAX	DD AX SP
DDAXI	DD AXI SP
DDAXNG	DD AX NG SP
DDEF	DD EF SP
DDEFN	DD EF N SP
DDEFO	DD EFO SP
DDESC	DD ES C SP
DDESO	DD ESO SP
DDEE	DD EE SP
DDEEM	DD EE M SP
DDEENH	DD EE NH SP
DDEEU	DD EEU SP
DDIFA	DD IFA SP
DDIFNH	DD IF NH SP
DDIFU	DD IFU SP
DDISCH	DD IS CH SP
DDISNH	DD IS NH SP
DDIST	DD IS T SP
DDOF	DD OF SP
DDOFI	DD OFI SP
DDOFM	DD OF M SP
DDOFN	DD OF N SP
DDOFNG	DD OF NG SP
DDOS	DD OS SP
DDOSA	DD OSA SP
DDOSI	DD OSI SP
DDOSM	DD OS M SP
DDOSN	DD OS N SP
DDOSNG	DD OS NG SP
DDOO	DD OO SP
DDOOI	DD OOI SP
DDOON	DD OO N SP
DDOONG	DD OO NG SP
DDUFA	DD UFA SP
DDUFI	DD UFI SP
DDUFM	DD UF M SP
DDUFNG	DD UF NG SP
DDUS	DD US SP
DDUSC	DD US C SP
DDUSM	DD US M SP
DDUSNG	DD US NG SP
DDUSP	DD US P SP
DDUST	DD US T SP
DDAWNG	DD AW NG SP
DDIX	DD IX SP
DDIXA	DD IXA SP
DDUXA	DD UXA SP
DDUXNG	DD UX NG SP
DDOW	DD OW SP
DDOWM	DD OW M SP
DDOWN	DD OW N SP
DDUWA	DD UWA SP
DDUWOWNG	DD UWOW NG SP
DDUWOWSC	DD UWOWS C SP
DDUWOWFNG	DD UWOWF NG SP
DDUWOWJC	DD UWOWJ C SP
DDAJC	DD AJ C SP
DDAJCH	DD AJ CH SP
DDAJI	DD AJI SP
DDAJM	DD AJ M SP
DDAJN	DD AJ N SP
DDAJO	DD AJO SP
DDAJP	DD AJ P SP
DDAJT	DD AJ T SP
DDAR	DD AR SP
DDARM	DD AR M SP
DDARN	DD AR N SP
DDARNG	DD AR NG SP
DDARO	DD ARO SP
DDAASM	DD AAS M SP
DDAAST	DD AAS T SP
DDAASU	DD AASU SP
DDAASY	DD AASY SP
DDAAFM	DD AAF M SP
DDAAFU	DD AAFU SP
DDAAFY	DD AAFY SP
DDAARU	DD AARU SP
DDAARY	DD AARY SP
DDAAXM	DD AAX M SP
DDAAXY	DD AAXY SP
DDAAJM	DD AAJ M SP
DDAAJN	DD AAJ N SP
DDAAJP	DD AAJ P SP
DDAAJT	DD AAJ T SP
DDAAJU	DD AAJU SP
DDAAJY	DD AAJY SP
DDAWSC	DD AWS C SP
DDAWSM	DD AWS M SP
DDAWSN	DD AWS N SP
DDAWSNG	DD AWS NG SP
DDAWSP	DD AWS P SP
DDAWST	DD AWS T SP
DDAWFM	DD AWF M SP
DDAWFNG	DD AWF NG SP
DDAWRNG	DD AWR NG SP
DDAWJC	DD AWJ C SP
DDAWJN	DD AWJ N SP
DDAWJNG	DD AWJ NG SP
DDAWJT	DD AWJ T SP
DDEJP	DD EJ P SP
DDER	DD ER SP
DDEX	DD EX SP
DDEXO	DD EXO SP
DDEES	DD EES SP
DDEESM	DD EES M SP
DDEESN	DD EES N SP
DDEEF	DD EEF SP
DDEEFM	DD EEF M SP
DDEEFN	DD EEF N SP
DDEEFNH	DD EEF NH SP
DDEEFU	DD EEFU SP
DDEER	DD EER SP
DDEERNH	DD EER NH SP
DDEERU	DD EERU SP
DDEEXNH	DD EEX NH SP
DDEEJ	DD EEJ SP
DDEEJM	DD EEJ M SP
DDIRNH	DD IR NH SP
DDIJA	DD IJA SP
DDIJCH	DD IJ CH SP
DDIJNH	DD IJ NH SP
DDIJU	DD IJU SP
DDOJ	DD OJ SP
DDOJC	DD OJ C SP
DDOJNG	DD OJ NG SP
DDOR	DD OR SP
DDOOS	DD OOS SP
DDOOSC	DD OOS C SP
DDOOSI	DD OOSI SP
DDOOSM	DD OOS M SP
DDOOSN	DD OOS N SP
DDOOSNG	DD OOS NG SP
DDOOST	DD OOS T SP
DDOOF	DD OOF SP
DDOOFI	DD OOFI SP
DDOOFN	DD OOF N SP
DDOOFNG	DD OOF NG SP
DDOOR	DD OOR SP
DDOORI	DD OORI SP
DDOORNG	DD OOR NG SP
DDOOX	DD OOX SP
DDOOXI	DD OOXI SP
DDOOJ	DD OOJ SP
DDOOJC	DD OOJ C SP
DDOOJI	DD OOJI SP
DDOOJN	DD OOJ N SP
DDOOJNG	DD OOJ NG SP
DDOOJP	DD OOJ P SP
DDOOJT	DD OOJ T SP
DDOWSI	DD OWSI SP
DDOWSN	DD OWS N SP
DDOWF	DD OWF SP
DDOWFI	DD OWFI SP
DDOWFM	DD OWF M SP
DDOWFN	DD OWF N SP
DDOWX	DD OWX SP
DDOWJI	DD OWJI SP
DDOWJP	DD OWJ P SP
DDOWJT	DD OWJ T SP
DDUJC	DD UJ C SP
DDUJN	DD UJ N SP
DDUJNG	DD UJ NG SP
DDUR	DD UR SP
DDUWSA	DD UWSA SP
DDUWSC	DD UWS C SP
DDUWSNG	DD UWS NG SP
DDUWST	DD UWS T SP
DDUWFNG	DD UWF NG SP
DDUWJNG	DD UWJ NG SP
IX	IX SP
OW	OW SP
OWI	OWI SP
OWN	OW N SP
UW	UW SP
UWA	UWA SP
UWNG	UW NG SP
UWU	UWU SP
UWOWM	UWOW M SP
UWOWNG	UWOW NG SP
UWOWSC	UWOWS C SP
UWOWSP	UWOWS P SP
UWOWST	UWOWS T SP
AJ	AJ SP
AJCH	AJ CH SP
AJT	AJ T SP
AR	AR SP
ARM	AR M SP
ARNH	AR NH SP
ARO	ARO SP
AASM	AAS M SP
AASN	AAS N SP
AASP	AAS P SP
AASU	AASU SP
AASY	AASY SP
AAFM	AAF M SP
AAFU	AAFU SP
AARM	AAR M SP
AARN	AAR N SP
AARU	AARU SP
AAJM	AAJ M SP
AWSP	AWS P SP
AWST	AWS T SP
AWFNG	AWF NG SP
AWXM	AWX M SP
AWJC	AWJ C SP
ERN	ER N SP
EES	EES SP
EESCH	EES CH SP
EEFNH	EEF NH SP
EEJCH	EEJ CH SP
EEJN	EEJ N SP
IRA	IRA SP
IRM	IR M SP
IRN	IR N SP
IRU	IRU SP
IJCH	IJ CH SP
OJC	OJ C SP
OJE	OJE SP
ORI	ORI SP
ORN	OR N SP
ORNG	OR NG SP
OOSC	OOS C SP
OOSM	OOS M SP
OOSNG	OOS NG SP
OOSP	OOS P SP
OOF	OOF SP
OOFN	OOF N SP
OOFNG	OOF NG SP
OOR	OOR SP
OORI	OORI SP
OORN	OOR N SP
OORNG	OOR NG SP
OOJC	OOJ C SP
OOJN	OOJ N SP
OOJP	OOJ P SP
OWS	OWS SP
OWSI	OWSI SP
OWSN	OWS N SP
OWST	OWS T SP
OWF	OWF SP
OWR	OWR SP
OWJ	OWJ SP
UJ	UJ SP
UJC	UJ C SP
UR	UR SP
URA	URA SP
URI	URI SP
URN	UR N SP
URNG	UR NG SP
URY	URY SP
UWS	UWS SP
UWSA	UWSA SP
UWSC	UWS C SP
UWSNG	UWS NG SP
UWF	UWF SP
UWRNG	UWR NG SP
YR	YR SP
