A	[A]	A
AI	[AI]	AI
AM	[AM]	A M
AN	[AN]	A N
ANG	[ANG]	A NG
ANH	[ANH]	A NH
AO	[AO]	AO
AU	[AU]	AU
B	[B]	B 
BA	[BA]	B A
BAN	[BAN]	B A N
BANG	[BANG]	B A NG
BANH	[BANH]	B A NH
BAO	[BAO]	B AO
BAY	[BAY]	B AY
BE	[BE]	B E
BEN	[BEN]	B E N
BENG	[BENG]	B E NG
BI	[BI]	B I
BIA	[BIA]	B IA
BINH	[BINH]	B I NH
BIEEN	[BIEEN]	B IEE N
BIEENG	[BIEENG]	B IEE NG
BIEESC	[BIEESC]	B IEES C
BIEESM	[BIEESM]	B IEES M
BIEESN	[BIEESN]	B IEES N
BIEESNG	[BIEESNG]	B IEES NG
BIEEST	[BIEEST]	B IEES T
BIEESU	[BIEESU]	B IEESU
BIEEFN	[BIEEFN]	B IEEF N
BIEERN	[BIEERN]	B IEER N
BIEERU	[BIEERU]	B IEERU
BIEEJN	[BIEEJN]	B IEEJ N
BIEEJT	[BIEEJT]	B IEEJ T
BO	[BO]	B O
BOA	[BOA]	B OA
BOM	[BOM]	B O M
BON	[BON]	B O N
BONG	[BONG]	B O NG
BU	[BU]	B U
BUNG	[BUNG]	B U NG
BUOON	[BUOON]	B UOO N
BUOONG	[BUOONG]	B UOO NG
BUYST	[BUYST]	B UYS T
BUOOST	[BUOOST]	B UOOS T
BUOOFN	[BUOOFN]	B UOOF N
BUOOFNG	[BUOOFNG]	B UOOF NG
BUOORI	[BUOORI]	B UOORI
BUOOJC	[BUOOJC]	B UOOJ C
BAF	[BAF]	B AF
BAFI	[BAFI]	B AFI
BAFN	[BAFN]	B AF N
BAFNG	[BAFNG]	B AF NG
BAFNH	[BAFNH]	B AF NH
BAFO	[BAFO]	B AFO
BAFU	[BAFU]	B AFU
BAFY	[BAFY]	B AFY
BAS	[BAS]	B AS
BASC	[BASC]	B AS C
BASCH	[BASCH]	B AS CH
BASI	[BASI]	B ASI
BASM	[BASM]	B AS M
BASN	[BASN]	B AS N
BASNG	[BASNG]	B AS NG
BASNH	[BASNH]	B AS NH
BASO	[BASO]	B ASO
BAST	[BAST]	B AS T
BASU	[BASU]	B ASU
BAANG	[BAANG]	B AA NG
BAAU	[BAAU]	B AAU
BAAY	[BAAY]	B AAY
BAX	[BAX]	B AX
BAXI	[BAXI]	B AXI
BAXO	[BAXO]	B AXO
BEF	[BEF]	B EF
BEFN	[BEFN]	B EF N
BEFO	[BEFO]	B EFO
BES	[BES]	B ES
BESN	[BESN]	B ES N
BESNG	[BESNG]	B ES NG
BESO	[BESO]	B ESO
BEST	[BEST]	B ES T
BEE	[BEE]	B EE
BEEN	[BEEN]	B EE N
BEENH	[BEENH]	B EE NH
BEEU	[BEEU]	B EEU
BIF	[BIF]	B IF
BIFA	[BIFA]	B IFA
BIFNH	[BIFNH]	B IF NH
BIFU	[BIFU]	B IFU
BIS	[BIS]	B IS
BISCH	[BISCH]	B IS CH
BISNH	[BISNH]	B IS NH
BISU	[BISU]	B ISU
BOF	[BOF]	B OF
BOS	[BOS]	B OS
BOSC	[BOSC]	B OS C
BOSI	[BOSI]	B OSI
BOSN	[BOSN]	B OS N
BOSNG	[BOSNG]	B OS NG
BOSP	[BOSP]	B OS P
BOST	[BOST]	B OS T
BOOI	[BOOI]	B OOI
BOONG	[BOONG]	B OO NG
BOXM	[BOXM]	B OX M
BOXNG	[BOXNG]	B OX NG
BUF	[BUF]	B UF
BUFA	[BUFA]	B UFA
BUFI	[BUFI]	B UFI
BUFN	[BUFN]	B UF N
BUFNG	[BUFNG]	B UF NG
BUS	[BUS]	B US
BUSA	[BUSA]	B USA
BUSN	[BUSN]	B US N
BUSNG	[BUSNG]	B US NG
BUSP	[BUSP]	B US P
BUST	[BUST]	B US T
BAWN	[BAWN]	B AW N
BAWNG	[BAWNG]	B AW NG
BIXNH	[BIXNH]	B IX NH
BIXU	[BIXU]	B IXU
BUXM	[BUXM]	B UX M
BOW	[BOW]	B OW
BOWI	[BOWI]	B OWI
BOWM	[BOWM]	B OW M
BUWNG	[BUWNG]	B UW NG
BUWU	[BUWU]	B UWU
BUWOWI	[BUWOWI]	B UWOWI
BUWOWM	[BUWOWM]	B UWOW M
BUWOWU	[BUWOWU]	B UWOWU
BUWOWSC	[BUWOWSC]	B UWOWS C
BUWOWSNG	[BUWOWSNG]	B UWOWS NG
BUWOWRI	[BUWOWRI]	B UWOWRI
BAJ	[BAJ]	B AJ
BAJC	[BAJC]	B AJ C
BAJCH	[BAJCH]	B AJ CH
BAJI	[BAJI]	B AJI
BAJN	[BAJN]	B AJ N
BAJO	[BAJO]	B AJO
BAJT	[BAJT]	B AJ T
BAR	[BAR]	B AR
BARN	[BARN]	B AR N
BARNG	[BARNG]	B AR NG
BARNH	[BARNH]	B AR NH
BARO	[BARO]	B ARO
BARY	[BARY]	B ARY
BAASC	[BAASC]	B AAS C
BAASM	[BAASM]	B AAS M
BAASP	[BAASP]	B AAS P
BAAST	[BAAST]	B AAS T
BAASU	[BAASU]	B AASU
BAASY	[BAASY]	B AASY
BAAFM	[BAAFM]	B AAF M
BAAFN	[BAAFN]	B AAF N
BAAFU	[BAAFU]	B AAFU
BAAFY	[BAAFY]	B AAFY
BAARM	[BAARM]	B AAR M
BAARN	[BAARN]	B AAR N
BAAXY	[BAAXY]	B AAXY
BAAJC	[BAAJC]	B AAJ C
BAAJN	[BAAJN]	B AAJ N
BAAJP	[BAAJP]	B AAJ P
BAAJT	[BAAJT]	B AAJ T
BAAJY	[BAAJY]	B AAJY
BAWSC	[BAWSC]	B AWS C
BAWSN	[BAWSN]	B AWS N
BAWSNG	[BAWSNG]	B AWS NG
BAWSP	[BAWSP]	B AWS P
BAWST	[BAWST]	B AWS T
BAWFM	[BAWFM]	B AWF M
BAWFNG	[BAWFNG]	B AWF NG
BAWXNG	[BAWXNG]	B AWX NG
BAWJM	[BAWJM]	B AWJ M
BAWJT	[BAWJT]	B AWJ T
BEJ	[BEJ]	B EJ
BEJO	[BEJO]	B EJO
BEJP	[BEJP]	B EJ P
BEJT	[BEJT]	B EJ T
BEXN	[BEXN]	B EX N
BEES	[BEES]	B EES
BEESN	[BEESN]	B EES N
BEESP	[BEESP]	B EES P
BEEST	[BEEST]	B EES T
BEEF	[BEEF]	B EEF
BEEFN	[BEEFN]	B EEF N
BEEFNH	[BEEFNH]	B EEF NH
BEEFU	[BEEFU]	B EEFU
BEER	[BEER]	B EER
BEEJ	[BEEJ]	B EEJ
BEEJCH	[BEEJCH]	B EEJ CH
BEEJN	[BEEJN]	B EEJ N
BEEJNH	[BEEJNH]	B EEJ NH
BEEJT	[BEEJT]	B EEJ T
BEEJU	[BEEJU]	B EEJU
BIR	[BIR]	B IR
BIRNH	[BIRNH]	B IR NH
BIRU	[BIRU]	B IRU
BIJ	[BIJ]	B IJ
BIJA	[BIJA]	B IJA
BIJCH	[BIJCH]	B IJ CH
BIJN	[BIJN]	B IJ N
BIJT	[BIJT]	B IJ T
BIJU	[BIJU]	B IJU
BOJ	[BOJ]	B OJ
BOJC	[BOJC]	B OJ C
BOJN	[BOJN]	B OJ N
BOJNG	[BOJNG]	B OJ NG
BOJP	[BOJP]	B OJ P
BOJT	[BOJT]	B OJ T
BOR	[BOR]	B OR
BOOS	[BOOS]	B OOS
BOOSC	[BOOSC]	B OOS C
BOOSI	[BOOSI]	B OOSI
BOOSN	[BOOSN]	B OOS N
BOOSNG	[BOOSNG]	B OOS NG
BOOF	[BOOF]	B OOF
BOOFI	[BOOFI]	B OOFI
BOOFN	[BOOFN]	B OOF N
BOOFNG	[BOOFNG]	B OOF NG
BOOR	[BOOR]	B OOR
BOORN	[BOORN]	B OOR N
BOORNG	[BOORNG]	B OOR NG
BOOX	[BOOX]	B OOX
BOOXNG	[BOOXNG]	B OOX NG
BOOJ	[BOOJ]	B OOJ
BOOJC	[BOOJC]	B OOJ C
BOOJI	[BOOJI]	B OOJI
BOOJNG	[BOOJNG]	B OOJ NG
BOOJT	[BOOJT]	B OOJ T
BOWSI	[BOWSI]	B OWSI
BOWST	[BOWST]	B OWS T
BOWF	[BOWF]	B OWF
BOWFI	[BOWFI]	B OWFI
BOWFM	[BOWFM]	B OWF M
BOWR	[BOWR]	B OWR
BOWRI	[BOWRI]	B OWRI
BOWX	[BOWX]	B OWX
BOWJ	[BOWJ]	B OWJ
BOWJM	[BOWJM]	B OWJ M
BOWJN	[BOWJN]	B OWJ N
BUJA	[BUJA]	B UJA
BUJC	[BUJC]	B UJ C
BUJI	[BUJI]	B UJI
BUJNG	[BUJNG]	B UJ NG
BUJT	[BUJT]	B UJ T
BURA	[BURA]	B URA
BURM	[BURM]	B UR M
BUWSC	[BUWSC]	B UWS C
BUWST	[BUWST]	B UWS T
BUWFA	[BUWFA]	B UWFA
BUWFNG	[BUWFNG]	B UWF NG
BUWRU	[BUWRU]	B UWRU
BUWXA	[BUWXA]	B UWXA
BUWJ	[BUWJ]	B UWJ
BUWJC	[BUWJC]	B UWJ C
C	[C]	C 
CA	[CA]	C A
CAI	[CAI]	C AI
CAM	[CAM]	C A M
CAN	[CAN]	C A N
CANH	[CANH]	C A NH
CAO	[CAO]	C AO
CAY	[CAY]	C AY
CHA	[CHA]	CH A
CHAI	[CHAI]	CH AI
CHAN	[CHAN]	CH A N
CHANG	[CHANG]	CH A NG
CHANH	[CHANH]	CH A NH
CHAO	[CHAO]	CH AO
CHAY	[CHAY]	CH AY
CHE	[CHE]	CH E
CHEM	[CHEM]	CH E M
CHEN	[CHEN]	CH E N
CHENG	[CHENG]	CH E NG
CHEO	[CHEO]	CH EO
CHI	[CHI]	CH I
CHIA	[CHIA]	CH IA
CHIM	[CHIM]	CH I M
CHINH	[CHINH]	CH I NH
CHIEEM	[CHIEEM]	CH IEE M
CHIEEN	[CHIEEN]	CH IEE N
CHIEENG	[CHIEENG]	CH IEE NG
CHIEEU	[CHIEEU]	CH IEEU
CHIEESC	[CHIEESC]	CH IEES C
CHIEESM	[CHIEESM]	CH IEES M
CHIEESN	[CHIEESN]	CH IEES N
CHIEESNG	[CHIEESNG]	CH IEES NG
CHIEEST	[CHIEEST]	CH IEES T
CHIEESU	[CHIEESU]	CH IEESU
CHIEEFN	[CHIEEFN]	CH IEEF N
CHIEEFU	[CHIEEFU]	CH IEEFU
CHIEERU	[CHIEERU]	CH IEERU
CHO	[CHO]	CH O
CHOANG	[CHOANG]	CH OA NG
CHONG	[CHONG]	CH O NG
CHOAFNG	[CHOAFNG]	CH OAF NG
CHOASNG	[CHOASNG]	CH OAS NG
CHOEFN	[CHOEFN]	CH OEF N
CHOAJC	[CHOAJC]	CH OAJ C
CHOAJNG	[CHOAJNG]	CH OAJ NG
CHOARNG	[CHOARNG]	CH OAR NG
CHOAWST	[CHOAWST]	CH OAWS T
CHU	[CHU]	CH U
CHUA	[CHUA]	CH UA
CHUI	[CHUI]	CH UI
CHUM	[CHUM]	CH U M
CHUNG	[CHUNG]	CH U NG
CHUYEEN	[CHUYEEN]	CH UYEE N
CHUYEESN	[CHUYEESN]	CH UYEES N
CHUYEEFN	[CHUYEEFN]	CH UYEEF N
CHUYEERN	[CHUYEERN]	CH UYEER N
CHUYEEJN	[CHUYEEJN]	CH UYEEJ N
CHUOOI	[CHUOOI]	CH UOOI
CHUOONG	[CHUOONG]	CH UOO NG
CHUAARN	[CHUAARN]	CH UAAR N
CHUOOSC	[CHUOOSC]	CH UOOS C
CHUOOSI	[CHUOOSI]	CH UOOSI
CHUOOST	[CHUOOST]	CH UOOS T
CHUOOFI	[CHUOOFI]	CH UOOFI
CHUOOFN	[CHUOOFN]	CH UOOF N
CHUOOFNG	[CHUOOFNG]	CH UOOF NG
CHUOOXI	[CHUOOXI]	CH UOOXI
CHUOOJC	[CHUOOJC]	CH UOOJ C
CHUOOJNG	[CHUOOJNG]	CH UOOJ NG
CHUOOJT	[CHUOOJT]	CH UOOJ T
CHAF	[CHAF]	CH AF
CHAFI	[CHAFI]	CH AFI
CHAFM	[CHAFM]	CH AF M
CHAFNG	[CHAFNG]	CH AF NG
CHAFNH	[CHAFNH]	CH AF NH
CHAFO	[CHAFO]	CH AFO
CHAFY	[CHAFY]	CH AFY
CHASC	[CHASC]	CH AS C
CHASI	[CHASI]	CH ASI
CHASN	[CHASN]	CH AS N
CHASNH	[CHASNH]	CH AS NH
CHASO	[CHASO]	CH ASO
CHAST	[CHAST]	CH AS T
CHASU	[CHASU]	CH ASU
CHASY	[CHASY]	CH ASY
CHAAM	[CHAAM]	CH AA M
CHAAN	[CHAAN]	CH AA N
CHAAU	[CHAAU]	CH AAU
CHAX	[CHAX]	CH AX
CHAXO	[CHAXO]	CH AXO
CHEF	[CHEF]	CH EF
CHEFN	[CHEFN]	CH EF N
CHEFO	[CHEFO]	CH EFO
CHES	[CHES]	CH ES
CHESM	[CHESM]	CH ES M
CHESN	[CHESN]	CH ES N
CHESO	[CHESO]	CH ESO
CHESP	[CHESP]	CH ES P
CHEST	[CHEST]	CH ES T
CHEE	[CHEE]	CH EE
CHEEM	[CHEEM]	CH EE M
CHEENH	[CHEENH]	CH EE NH
CHIF	[CHIF]	CH IF
CHIFM	[CHIFM]	CH IF M
CHIFU	[CHIFU]	CH IFU
CHIS	[CHIS]	CH IS
CHISCH	[CHISCH]	CH IS CH
CHISN	[CHISN]	CH IS N
CHISNH	[CHISNH]	CH IS NH
CHIST	[CHIST]	CH IS T
CHOF	[CHOF]	CH OF
CHOFNG	[CHOFNG]	CH OF NG
CHOS	[CHOS]	CH OS
CHOSE	[CHOSE]	CH OSE
CHOSI	[CHOSI]	CH OSI
CHOSNG	[CHOSNG]	CH OS NG
CHOST	[CHOST]	CH OS T
CHOON	[CHOON]	CH OO N
CHOONG	[CHOONG]	CH OO NG
CHUF	[CHUF]	CH UF
CHUFA	[CHUFA]	CH UFA
CHUFI	[CHUFI]	CH UFI
CHUFM	[CHUFM]	CH UF M
CHUS	[CHUS]	CH US
CHUSA	[CHUSA]	CH USA
CHUSC	[CHUSC]	CH US C
CHUSI	[CHUSI]	CH USI
CHUSNG	[CHUSNG]	CH US NG
CHUST	[CHUST]	CH US T
CHAWM	[CHAWM]	CH AW M
CHAWN	[CHAWN]	CH AW N
CHAWNG	[CHAWNG]	CH AW NG
CHIXN	[CHIXN]	CH IX N
CHUXI	[CHUXI]	CH UXI
CHUXN	[CHUXN]	CH UX N
CHOW	[CHOW]	CH OW
CHOWI	[CHOWI]	CH OWI
CHUW	[CHUW]	CH UW
CHUWA	[CHUWA]	CH UWA
CHUWNG	[CHUWNG]	CH UW NG
CHUWOWNG	[CHUWOWNG]	CH UWOW NG
CHUWOWSC	[CHUWOWSC]	CH UWOWS C
CHUWOWSNG	[CHUWOWSNG]	CH UWOWS NG
CHUWOWFM	[CHUWOWFM]	CH UWOWF M
CHUWOWJC	[CHUWOWJC]	CH UWOWJ C
CHAJCH	[CHAJCH]	CH AJ CH
CHAJM	[CHAJM]	CH AJ M
CHAJN	[CHAJN]	CH AJ N
CHAJNH	[CHAJNH]	CH AJ NH
CHAJP	[CHAJP]	CH AJ P
CHAJY	[CHAJY]	CH AJY
CHAR	[CHAR]	CH AR
CHARI	[CHARI]	CH ARI
CHARO	[CHARO]	CH ARO
CHARY	[CHARY]	CH ARY
CHAASM	[CHAASM]	CH AAS M
CHAASN	[CHAASN]	CH AAS N
CHAASP	[CHAASP]	CH AAS P
CHAAST	[CHAAST]	CH AAS T
CHAASU	[CHAASU]	CH AASU
CHAAFM	[CHAAFM]	CH AAF M
CHAAFU	[CHAAFU]	CH AAFU
CHAARM	[CHAARM]	CH AAR M
CHAARN	[CHAARN]	CH AAR N
CHAAJM	[CHAAJM]	CH AAJ M
CHAAJP	[CHAAJP]	CH AAJ P
CHAAJT	[CHAAJT]	CH AAJ T
CHAAJU	[CHAAJU]	CH AAJU
CHAWSC	[CHAWSC]	CH AWS C
CHAWSM	[CHAWSM]	CH AWS M
CHAWSN	[CHAWSN]	CH AWS N
CHAWSP	[CHAWSP]	CH AWS P
CHAWST	[CHAWST]	CH AWS T
CHAWFM	[CHAWFM]	CH AWF M
CHAWFN	[CHAWFN]	CH AWF N
CHAWFNG	[CHAWFNG]	CH AWF NG
CHAWRNG	[CHAWRNG]	CH AWR NG
CHAWXN	[CHAWXN]	CH AWX N
CHAWJN	[CHAWJN]	CH AWJ N
CHAWJNG	[CHAWJNG]	CH AWJ NG
CHAWJT	[CHAWJT]	CH AWJ T
CHEJN	[CHEJN]	CH EJ N
CHEJO	[CHEJO]	CH EJO
CHEJP	[CHEJP]	CH EJ P
CHER	[CHER]	CH ER
CHEX	[CHEX]	CH EX
CHEXN	[CHEXN]	CH EX N
CHEES	[CHEES]	CH EES
CHEEST	[CHEEST]	CH EES T
CHEEF	[CHEEF]	CH EEF
CHEEFNH	[CHEEFNH]	CH EEF NH
CHEERNH	[CHEERNH]	CH EER NH
CHEEJCH	[CHEEJCH]	CH EEJ CH
CHIR	[CHIR]	CH IR
CHIRNH	[CHIRNH]	CH IR NH
CHIJ	[CHIJ]	CH IJ
CHIJT	[CHIJT]	CH IJ T
CHIJU	[CHIJU]	CH IJU
CHOJC	[CHOJC]	CH OJ C
CHOJI	[CHOJI]	CH OJI
CHOJN	[CHOJN]	CH OJ N
CHOJT	[CHOJT]	CH OJ T
CHOR	[CHOR]	CH OR
CHORM	[CHORM]	CH OR M
CHORN	[CHORN]	CH OR N
CHOOSC	[CHOOSC]	CH OOS C
CHOOSI	[CHOOSI]	CH OOSI
CHOOSN	[CHOOSN]	CH OOS N
CHOOSNG	[CHOOSNG]	CH OOS NG
CHOOST	[CHOOST]	CH OOS T
CHOOFI	[CHOOFI]	CH OOFI
CHOOFM	[CHOOFM]	CH OOF M
CHOOFN	[CHOOFN]	CH OOF N
CHOOFNG	[CHOOFNG]	CH OOF NG
CHOORI	[CHOORI]	CH OORI
CHOOX	[CHOOX]	CH OOX
CHOOJP	[CHOOJP]	CH OOJ P
CHOWS	[CHOWS]	CH OWS
CHOWSI	[CHOWSI]	CH OWSI
CHOWF	[CHOWF]	CH OWF
CHOWFN	[CHOWFN]	CH OWF N
CHOWR	[CHOWR]	CH OWR
CHOWJ	[CHOWJ]	CH OWJ
CHOWJP	[CHOWJP]	CH OWJ P
CHOWJT	[CHOWJT]	CH OWJ T
CHUJC	[CHUJC]	CH UJ C
CHUJM	[CHUJM]	CH UJ M
CHUJP	[CHUJP]	CH UJ P
CHUR	[CHUR]	CH UR
CHURNG	[CHURNG]	CH UR NG
CHUWS	[CHUWS]	CH UWS
CHUWSA	[CHUWSA]	CH UWSA
CHUWSC	[CHUWSC]	CH UWS C
CHUWSNG	[CHUWSNG]	CH UWS NG
CHUWF	[CHUWF]	CH UWF
CHUWFNG	[CHUWFNG]	CH UWF NG
CHUWRA	[CHUWRA]	CH UWRA
CHUWRI	[CHUWRI]	CH UWRI
CHUWRNG	[CHUWRNG]	CH UWR NG
CHUWX	[CHUWX]	CH UWX
CHUWXA	[CHUWXA]	CH UWXA
CHUWXNG	[CHUWXNG]	CH UWX NG
CHUWJC	[CHUWJC]	CH UWJ C
CO	[CO]	C O
COI	[COI]	C OI
CON	[CON]	C O N
CONG	[CONG]	C O NG
CU	[CU]	C U
CUA	[CUA]	C UA
CUN	[CUN]	C U N
CUNG	[CUNG]	C U NG
CUOONG	[CUOONG]	C UOO NG
CUOOSC	[CUOOSC]	C UOOS C
CUOOSI	[CUOOSI]	C UOOSI
CUOOSN	[CUOOSN]	C UOOS N
CUOOSNG	[CUOOSNG]	C UOOS NG
CUOOFN	[CUOOFN]	C UOOF N
CUOOFNG	[CUOOFNG]	C UOOF NG
CUOOXM	[CUOOXM]	C UOOX M
CUOOJC	[CUOOJC]	C UOOJ C
CUOOJI	[CUOOJI]	C UOOJI
CUOOJN	[CUOOJN]	C UOOJ N
CAF	[CAF]	C AF
CAFI	[CAFI]	C AFI
CAFNG	[CAFNG]	C AF NG
CAFNH	[CAFNH]	C AF NH
CAFO	[CAFO]	C AFO
CAFU	[CAFU]	C AFU
CAFY	[CAFY]	C AFY
CAS	[CAS]	C AS
CASC	[CASC]	C AS C
CASCH	[CASCH]	C AS CH
CASI	[CASI]	C ASI
CASM	[CASM]	C AS M
CASN	[CASN]	C AS N
CASNG	[CASNG]	C AS NG
CASNH	[CASNH]	C AS NH
CASO	[CASO]	C ASO
CASP	[CASP]	C AS P
CAST	[CAST]	C AS T
CASU	[CASU]	C ASU
CASY	[CASY]	C ASY
CAAM	[CAAM]	C AA M
CAAN	[CAAN]	C AA N
CAAU	[CAAU]	C AAU
CAAY	[CAAY]	C AAY
CAXI	[CAXI]	C AXI
COF	[COF]	C OF
COFI	[COFI]	C OFI
COFM	[COFM]	C OF M
COFN	[COFN]	C OF N
COFNG	[COFNG]	C OF NG
COS	[COS]	C OS
COSC	[COSC]	C OS C
COSNG	[COSNG]	C OS NG
COSP	[COSP]	C OS P
COST	[COST]	C OS T
COO	[COO]	C OO
COOI	[COOI]	C OOI
COOM	[COOM]	C OO M
COON	[COON]	C OO N
COONG	[COONG]	C OO NG
COXI	[COXI]	C OXI
COXNG	[COXNG]	C OX NG
CUF	[CUF]	C UF
CUFI	[CUFI]	C UFI
CUFN	[CUFN]	C UF N
CUFNG	[CUFNG]	C UF NG
CUS	[CUS]	C US
CUSC	[CUSC]	C US C
CUSI	[CUSI]	C USI
CUSM	[CUSM]	C US M
CUSNG	[CUSNG]	C US NG
CUSP	[CUSP]	C US P
CUST	[CUST]	C US T
CAWM	[CAWM]	C AW M
CAWN	[CAWN]	C AW N
CAWNG	[CAWNG]	C AW NG
CUX	[CUX]	C UX
CUXI	[CUXI]	C UXI
CUXN	[CUXN]	C UX N
CUXNG	[CUXNG]	C UX NG
COW	[COW]	C OW
COWI	[COWI]	C OWI
COWM	[COWM]	C OW M
COWN	[COWN]	C OW N
CUW	[CUW]	C UW
CUWA	[CUWA]	C UWA
CUWNG	[CUWNG]	C UW NG
CUWU	[CUWU]	C UWU
CUWOWNG	[CUWOWNG]	C UWOW NG
CUWOWSC	[CUWOWSC]	C UWOWS C
CUWOWSI	[CUWOWSI]	C UWOWSI
CUWOWSP	[CUWOWSP]	C UWOWS P
CUWOWFI	[CUWOWFI]	C UWOWFI
CUWOWFM	[CUWOWFM]	C UWOWF M
CUWOWFNG	[CUWOWFNG]	C UWOWF NG
CUWOWXI	[CUWOWXI]	C UWOWXI
CUWOWXNG	[CUWOWXNG]	C UWOWX NG
CAJC	[CAJC]	C AJ C
CAJCH	[CAJCH]	C AJ CH
CAJM	[CAJM]	C AJ M
CAJN	[CAJN]	C AJ N
CAJNH	[CAJNH]	C AJ NH
CAJO	[CAJO]	C AJO
CAJP	[CAJP]	C AJ P
CAJU	[CAJU]	C AJU
CAJY	[CAJY]	C AJY
CAR	[CAR]	C AR
CARI	[CARI]	C ARI
CARM	[CARM]	C AR M
CARN	[CARN]	C AR N
CARNG	[CARNG]	C AR NG
CARNH	[CARNH]	C AR NH
CARO	[CARO]	C ARO
CAASM	[CAASM]	C AAS M
CAASP	[CAASP]	C AAS P
CAAST	[CAAST]	C AAS T
CAASU	[CAASU]	C AASU
CAASY	[CAASY]	C AASY
CAAFM	[CAAFM]	C AAF M
CAAFN	[CAAFN]	C AAF N
CAAFU	[CAAFU]	C AAFU
CAAFY	[CAAFY]	C AAFY
CAARM	[CAARM]	C AAR M
CAARN	[CAARN]	C AAR N
CAARU	[CAARU]	C AARU
CAAXNG	[CAAXNG]	C AAX NG
CAAJN	[CAAJN]	C AAJ N
CAAJP	[CAAJP]	C AAJ P
CAAJT	[CAAJT]	C AAJ T
CAAJU	[CAAJU]	C AAJU
CAAJY	[CAAJY]	C AAJY
CAWSC	[CAWSC]	C AWS C
CAWSM	[CAWSM]	C AWS M
CAWSN	[CAWSN]	C AWS N
CAWSP	[CAWSP]	C AWS P
CAWST	[CAWST]	C AWS T
CAWFM	[CAWFM]	C AWF M
CAWFN	[CAWFN]	C AWF N
CAWRNG	[CAWRNG]	C AWR NG
CAWJM	[CAWJM]	C AWJ M
CAWJN	[CAWJN]	C AWJ N
CAWJP	[CAWJP]	C AWJ P
COJ	[COJ]	C OJ
COJC	[COJC]	C OJ C
COJN	[COJN]	C OJ N
COJNG	[COJNG]	C OJ NG
COJP	[COJP]	C OJ P
COJT	[COJT]	C OJ T
COR	[COR]	C OR
CORI	[CORI]	C ORI
CORM	[CORM]	C OR M
COOS	[COOS]	C OOS
COOSC	[COOSC]	C OOS C
COOSI	[COOSI]	C OOSI
COOSM	[COOSM]	C OOS M
COOSNG	[COOSNG]	C OOS NG
COOST	[COOST]	C OOS T
COOF	[COOF]	C OOF
COOFM	[COOFM]	C OOF M
COOFN	[COOFN]	C OOF N
COOFNG	[COOFNG]	C OOF NG
COOR	[COOR]	C OOR
COORNG	[COORNG]	C OOR NG
COOX	[COOX]	C OOX
COOXI	[COOXI]	C OOXI
COOJ	[COOJ]	C OOJ
COOJI	[COOJI]	C OOJI
COOJNG	[COOJNG]	C OOJ NG
COOJP	[COOJP]	C OOJ P
COOJT	[COOJT]	C OOJ T
COWS	[COWS]	C OWS
COWF	[COWF]	C OWF
COWFI	[COWFI]	C OWFI
COWRI	[COWRI]	C OWRI
COWX	[COWX]	C OWX
COWJT	[COWJT]	C OWJ T
CUJ	[CUJ]	C UJ
CUJC	[CUJC]	C UJ C
CUJI	[CUJI]	C UJI
CUJM	[CUJM]	C UJ M
CUJP	[CUJP]	C UJ P
CUJT	[CUJT]	C UJ T
CUR	[CUR]	C UR
CURA	[CURA]	C URA
CURI	[CURI]	C URI
CURNG	[CURNG]	C UR NG
CUWS	[CUWS]	C UWS
CUWSA	[CUWSA]	C UWSA
CUWSNG	[CUWSNG]	C UWS NG
CUWSU	[CUWSU]	C UWSU
CUWF	[CUWF]	C UWF
CUWFU	[CUWFU]	C UWFU
CUWR	[CUWR]	C UWR
CUWRA	[CUWRA]	C UWRA
CUWRI	[CUWRI]	C UWRI
CUWRU	[CUWRU]	C UWRU
CUWX	[CUWX]	C UWX
CUWJ	[CUWJ]	C UWJ
CUWJA	[CUWJA]	C UWJA
CUWJC	[CUWJC]	C UWJ C
CUWJU	[CUWJU]	C UWJU
D	[D]	D 
DA	[DA]	D A
DAI	[DAI]	D AI
DANG	[DANG]	D A NG
DANH	[DANH]	D A NH
DAO	[DAO]	D AO
DI	[DI]	D I
DIM	[DIM]	D I M
DINH	[DINH]	D I NH
DIEEM	[DIEEM]	D IEE M
DIEEN	[DIEEN]	D IEE N
DIEEU	[DIEEU]	D IEEU
DIEESC	[DIEESC]	D IEES C
DIEEST	[DIEEST]	D IEES T
DIEESU	[DIEESU]	D IEESU
DIEEFU	[DIEEFU]	D IEEFU
DIEEXM	[DIEEXM]	D IEEX M
DIEEXN	[DIEEXN]	D IEEX N
DIEEJC	[DIEEJC]	D IEEJ C
DIEEJM	[DIEEJM]	D IEEJ M
DIEEJN	[DIEEJN]	D IEEJ N
DIEEJP	[DIEEJP]	D IEEJ P
DIEEJT	[DIEEJT]	D IEEJ T
DIEEJU	[DIEEJU]	D IEEJU
DO	[DO]	D O
DOANH	[DOANH]	D OA NH
DOI	[DOI]	D OI
DONG	[DONG]	D O NG
DOAXN	[DOAXN]	D OAX N
DU	[DU]	D U
DUA	[DUA]	D UA
DUNG	[DUNG]	D U NG
DUY	[DUY]	D UY
DUYEEN	[DUYEEN]	D UYEE N
DUYEEJT	[DUYEEJT]	D UYEEJ T
DUOOXI	[DUOOXI]	D UOOXI
DAF	[DAF]	D AF
DAFI	[DAFI]	D AFI
DAFN	[DAFN]	D AF N
DAFNG	[DAFNG]	D AF NG
DAFNH	[DAFNH]	D AF NH
DAFO	[DAFO]	D AFO
DAFY	[DAFY]	D AFY
DASC	[DASC]	D AS C
DASM	[DASM]	D AS M
DASN	[DASN]	D AS N
DASNG	[DASNG]	D AS NG
DASO	[DASO]	D ASO
DAAM	[DAAM]	D AA M
DAAN	[DAAN]	D AA N
DAANG	[DAANG]	D AA NG
DAAU	[DAAU]	D AAU
DAAY	[DAAY]	D AAY
DAX	[DAX]	D AX
DAXNG	[DAXNG]	D AX NG
DAXY	[DAXY]	D AXY
DEF	[DEF]	D EF
DESP	[DESP]	D ES P
DEE	[DEE]	D EE
DIF	[DIF]	D IF
DIFU	[DIFU]	D IFU
DIS	[DIS]	D IS
DISNH	[DISNH]	D IS NH
DOF	[DOF]	D OF
DOFI	[DOFI]	D OFI
DOFM	[DOFM]	D OF M
DOFNG	[DOFNG]	D OF NG
DOS	[DOS]	D OS
DOSC	[DOSC]	D OS C
DOSM	[DOSM]	D OS M
DOOI	[DOOI]	D OOI
DOONG	[DOONG]	D OO NG
DOXI	[DOXI]	D OXI
DOXNG	[DOXNG]	D OX NG
DUF	[DUF]	D UF
DUFI	[DUFI]	D UFI
DUFNG	[DUFNG]	D UF NG
DUSM	[DUSM]	D US M
DAWM	[DAWM]	D AW M
DAWN	[DAWN]	D AW N
DIX	[DIX]	D IX
DIXA	[DIXA]	D IXA
DUXNG	[DUXNG]	D UX NG
DOWI	[DOWI]	D OWI
DUW	[DUW]	D UW
DUWA	[DUWA]	D UWA
DUWNG	[DUWNG]	D UW NG
DUWOWNG	[DUWOWNG]	D UWOW NG
DUWOWSI	[DUWOWSI]	D UWOWSI
DUWOWFNG	[DUWOWFNG]	D UWOWF NG
DUWOWXNG	[DUWOWXNG]	D UWOWX NG
DUWOWJC	[DUWOWJC]	D UWOWJ C
DUWOWJT	[DUWOWJT]	D UWOWJ T
DAJ	[DAJ]	D AJ
DAJC	[DAJC]	D AJ C
DAJI	[DAJI]	D AJI
DAJM	[DAJM]	D AJ M
DAJN	[DAJN]	D AJ N
DAJNG	[DAJNG]	D AJ NG
DAJO	[DAJO]	D AJO
DAJT	[DAJT]	D AJ T
DAJY	[DAJY]	D AJY
DAR	[DAR]	D AR
DARI	[DARI]	D ARI
DAASN	[DAASN]	D AAS N
DAASP	[DAASP]	D AAS P
DAASU	[DAASU]	D AASU
DAASY	[DAASY]	D AASY
DAAFM	[DAAFM]	D AAF M
DAAFN	[DAAFN]	D AAF N
DAAFU	[DAAFU]	D AAFU
DAARN	[DAARN]	D AAR N
DAAXM	[DAAXM]	D AAX M
DAAXN	[DAAXN]	D AAX N
DAAXU	[DAAXU]	D AAXU
DAAXY	[DAAXY]	D AAXY
DAAJM	[DAAJM]	D AAJ M
DAAJP	[DAAJP]	D AAJ P
DAAJY	[DAAJY]	D AAJY
DAWST	[DAWST]	D AWS T
DAWFN	[DAWFN]	D AWF N
DAWFNG	[DAWFNG]	D AWF NG
DAWRNG	[DAWRNG]	D AWR NG
DAWJC	[DAWJC]	D AWJ C
DAWJM	[DAWJM]	D AWJ M
DAWJN	[DAWJN]	D AWJ N
DEJP	[DEJP]	D EJ P
DEJT	[DEJT]	D EJ T
DERO	[DERO]	D ERO
DEES	[DEES]	D EES
DEEF	[DEEF]	D EEF
DEEFNH	[DEEFNH]	D EEF NH
DEEX	[DEEX]	D EEX
DEEJT	[DEEJT]	D EEJ T
DIJ	[DIJ]	D IJ
DIJCH	[DIJCH]	D IJ CH
DIJP	[DIJP]	D IJ P
DIJU	[DIJU]	D IJU
DOJA	[DOJA]	D OJA
DOJC	[DOJC]	D OJ C
DOJN	[DOJN]	D OJ N
DORNG	[DORNG]	D OR NG
DOOSC	[DOOSC]	D OOS C
DOOSI	[DOOSI]	D OOSI
DOOST	[DOOST]	D OOS T
DOOFI	[DOOFI]	D OOFI
DOOFN	[DOOFN]	D OOF N
DOOX	[DOOX]	D OOX
DOOXI	[DOOXI]	D OOXI
DOOJI	[DOOJI]	D OOJI
DOOJT	[DOOJT]	D OOJ T
DOWS	[DOWS]	D OWS
DOWFI	[DOWFI]	D OWFI
DOWFN	[DOWFN]	D OWF N
DOWR	[DOWR]	D OWR
DOWX	[DOWX]	D OWX
DUJ	[DUJ]	D UJ
DUJC	[DUJC]	D UJ C
DUJNG	[DUJNG]	D UJ NG
DUWSA	[DUWSA]	D UWSA
DUWST	[DUWST]	D UWS T
DUWFA	[DUWFA]	D UWFA
DUWFNG	[DUWFNG]	D UWF NG
DUWR	[DUWR]	D UWR
DUWRNG	[DUWRNG]	D UWR NG
DUWX	[DUWX]	D UWX
DUWJ	[DUWJ]	D UWJ
DUWJA	[DUWJA]	D UWJA
DUWJC	[DUWJC]	D UWJ C
DUWJNG	[DUWJNG]	D UWJ NG
E	[E]	E
EM	[EM]	E M
EO	[EO]	EO
GA	[GA]	G A
GAI	[GAI]	G AI
GAM	[GAM]	G A M
GAN	[GAN]	G A N
GANG	[GANG]	G A NG
GANH	[GANH]	G A NH
GAO	[GAO]	G AO
GAY	[GAY]	G AY
GEN	[GEN]	G E N
GHE	[GHE]	GH E
GHEN	[GHEN]	GH E N
GHI	[GHI]	GH I
GHIM	[GHIM]	GH I M
GHIEEFN	[GHIEEFN]	GH IEEF N
GHEF	[GHEF]	GH EF
GHEFN	[GHEFN]	GH EF N
GHES	[GHES]	GH ES
GHESM	[GHESM]	GH ES M
GHESP	[GHESP]	GH ES P
GHEST	[GHEST]	GH ES T
GHEE	[GHEE]	GH EE
GHIF	[GHIF]	GH IF
GHIFM	[GHIFM]	GH IF M
GHEJ	[GHEJ]	GH EJ
GHEJO	[GHEJO]	GH EJO
GHER	[GHER]	GH ER
GHEX	[GHEX]	GH EX
GHEES	[GHEES]	GH EES
GHEEF	[GHEEF]	GH EEF
GHEEFNH	[GHEEFNH]	GH EEF NH
GHEERNH	[GHEERNH]	GH EER NH
GIA	[GIA]	GI A
GIAI	[GIAI]	GI AI
GIAM	[GIAM]	GI A M
GIAN	[GIAN]	GI A N
GIANG	[GIANG]	GI A NG
GIANH	[GIANH]	GI A NH
GIAO	[GIAO]	GI AO
GIEO	[GIEO]	GI EO
GION	[GION]	GI O N
GIUA	[GIUA]	GI UA
GIUN	[GIUN]	GI U N
GIAF	[GIAF]	GI AF
GIAFN	[GIAFN]	GI AF N
GIAFNH	[GIAFNH]	GI AF NH
GIAFU	[GIAFU]	GI AFU
GIAFY	[GIAFY]	GI AFY
GIAS	[GIAS]	GI AS
GIASC	[GIASC]	GI AS C
GIASM	[GIASM]	GI AS M
GIASN	[GIASN]	GI AS N
GIASNG	[GIASNG]	GI AS NG
GIASO	[GIASO]	GI ASO
GIASP	[GIASP]	GI AS P
GIAAY	[GIAAY]	GI AAY
GIAX	[GIAX]	GI AX
GIAXN	[GIAXN]	GI AX N
GIAXY	[GIAXY]	GI AXY
GIEFM	[GIEFM]	GI EF M
GIES	[GIES]	GI ES
GIEENG	[GIEENG]	GI EE NG
GIOF	[GIOF]	GI OF
GIOFN	[GIOFN]	GI OF N
GIOS	[GIOS]	GI OS
GIOSN	[GIOSN]	GI OS N
GIOSNG	[GIOSNG]	GI OS NG
GIOONG	[GIOONG]	GI OO NG
GIUFM	[GIUFM]	GI UF M
GIUS	[GIUS]	GI US
GIUSP	[GIUSP]	GI US P
GIAWM	[GIAWM]	GI AW M
GIAWNG	[GIAWNG]	GI AW NG
GIUX	[GIUX]	GI UX
GIUXA	[GIUXA]	GI UXA
GIOW	[GIOW]	GI OW
GIUWOWNG	[GIUWOWNG]	GI UWOW NG
GIUWOWSNG	[GIUWOWSNG]	GI UWOWS NG
GIUWOWFNG	[GIUWOWFNG]	GI UWOWF NG
GIAJT	[GIAJT]	GI AJ T
GIAR	[GIAR]	GI AR
GIARI	[GIARI]	GI ARI
GIARM	[GIARM]	GI AR M
GIARN	[GIARN]	GI AR N
GIARNG	[GIARNG]	GI AR NG
GIARNH	[GIARNH]	GI AR NH
GIAASC	[GIAASC]	GI AAS C
GIAASM	[GIAASM]	GI AAS M
GIAASP	[GIAASP]	GI AAS P
GIAASU	[GIAASU]	GI AASU
GIAASY	[GIAASY]	GI AASY
GIAAFM	[GIAAFM]	GI AAF M
GIAAFN	[GIAAFN]	GI AAF N
GIAAFY	[GIAAFY]	GI AAFY
GIAAXM	[GIAAXM]	GI AAX M
GIAAJM	[GIAAJM]	GI AAJ M
GIAAJN	[GIAAJN]	GI AAJ N
GIAAJP	[GIAAJP]	GI AAJ P
GIAAJT	[GIAAJT]	GI AAJ T
GIAWST	[GIAWST]	GI AWS T
GIAWFM	[GIAWFM]	GI AWF M
GIAWFNG	[GIAWFNG]	GI AWF NG
GIAWJC	[GIAWJC]	GI AWJ C
GIAWJM	[GIAWJM]	GI AWJ M
GIAWJN	[GIAWJN]	GI AWJ N
GIAWJT	[GIAWJT]	GI AWJ T
GIEJO	[GIEJO]	GI EJO
GIEESM	[GIEESM]	GI EES M
GIEESNG	[GIEESNG]	GI EES NG
GIEEST	[GIEEST]	GI EES T
GIEEFNG	[GIEEFNG]	GI EEF NG
GIEEXU	[GIEEXU]	GI EEXU
GIOJ	[GIOJ]	GI OJ
GIOJNG	[GIOJNG]	GI OJ NG
GIOJT	[GIOJT]	GI OJ T
GIOR	[GIOR]	GI OR
GIORI	[GIORI]	GI ORI
GIORN	[GIORN]	GI OR N
GIOOSNG	[GIOOSNG]	GI OOS NG
GIOOFNG	[GIOOFNG]	GI OOF NG
GIOOX	[GIOOX]	GI OOX
GIOWSI	[GIOWSI]	GI OWSI
GIOWF	[GIOWF]	GI OWF
GIOWFI	[GIOWFI]	GI OWFI
GIOWR	[GIOWR]	GI OWR
GIOWXN	[GIOWXN]	GI OWX N
GIUJA	[GIUJA]	GI UJA
GIUJC	[GIUJC]	GI UJ C
GIURI	[GIURI]	GI URI
GIUWX	[GIUWX]	GI UWX
GIUWXA	[GIUWXA]	GI UWXA
GIUWJT	[GIUWJT]	GI UWJ T
GO	[GO]	G O
GOM	[GOM]	G O M
GU	[GU]	G U
GUOOSC	[GUOOSC]	G UOOS C
GUOOJC	[GUOOJC]	G UOOJ C
GAF	[GAF]	G AF
GAFI	[GAFI]	G AFI
GAFN	[GAFN]	G AF N
GAFNG	[GAFNG]	G AF NG
GAFNH	[GAFNH]	G AF NH
GAFO	[GAFO]	G AFO
GAFU	[GAFU]	G AFU
GASC	[GASC]	G AS C
GASI	[GASI]	G ASI
GASN	[GASN]	G AS N
GASNH	[GASNH]	G AS NH
GASO	[GASO]	G ASO
GASP	[GASP]	G AS P
GASY	[GASY]	G ASY
GAAN	[GAAN]	G AA N
GAAY	[GAAY]	G AAY
GAX	[GAX]	G AX
GAXI	[GAXI]	G AXI
GAXY	[GAXY]	G AXY
GIF	[GIF]	G IF
GIFN	[GIFN]	G IF N
GIS	[GIS]	G IS
GOF	[GOF]	G OF
GOFN	[GOFN]	G OF N
GOSA	[GOSA]	G OSA
GOSC	[GOSC]	G OS C
GOSI	[GOSI]	G OSI
GOSP	[GOSP]	G OS P
GOST	[GOST]	G OS T
GOO	[GOO]	G OO
GOON	[GOON]	G OO N
GOONG	[GOONG]	G OO NG
GOX	[GOX]	G OX
GUF	[GUF]	G UF
GUS	[GUS]	G US
GUST	[GUST]	G US T
GAWM	[GAWM]	G AW M
GUXI	[GUXI]	G UXI
GUWOWM	[GUWOWM]	G UWOW M
GUWOWNG	[GUWOWNG]	G UWOW NG
GUWOWFM	[GUWOWFM]	G UWOWF M
GUWOWFNG	[GUWOWFNG]	G UWOWF NG
GUWOWJNG	[GUWOWJNG]	G UWOWJ NG
GAJ	[GAJ]	G AJ
GAJCH	[GAJCH]	G AJ CH
GAJN	[GAJN]	G AJ N
GAJO	[GAJO]	G AJO
GAJT	[GAJT]	G AJ T
GAR	[GAR]	G AR
GARY	[GARY]	G ARY
GAASP	[GAASP]	G AAS P
GAASU	[GAASU]	G AASU
GAASY	[GAASY]	G AASY
GAAFM	[GAAFM]	G AAF M
GAAFN	[GAAFN]	G AAF N
GAAFU	[GAAFU]	G AAFU
GAAFY	[GAAFY]	G AAFY
GAAXM	[GAAXM]	G AAX M
GAAXU	[GAAXU]	G AAXU
GAAJP	[GAAJP]	G AAJ P
GAAJT	[GAAJT]	G AAJ T
GAAJY	[GAAJY]	G AAJY
GAWSM	[GAWSM]	G AWS M
GAWSN	[GAWSN]	G AWS N
GAWSNG	[GAWSNG]	G AWS NG
GAWSP	[GAWSP]	G AWS P
GAWST	[GAWST]	G AWS T
GAWFN	[GAWFN]	G AWF N
GAWJM	[GAWJM]	G AWJ M
GAWJNG	[GAWJNG]	G AWJ NG
GAWJP	[GAWJP]	G AWJ P
GAWJT	[GAWJT]	G AWJ T
GIR	[GIR]	G IR
GOJI	[GOJI]	G OJI
GOJN	[GOJN]	G OJ N
GOJT	[GOJT]	G OJ T
GORI	[GORI]	G ORI
GORNG	[GORNG]	G OR NG
GOOSC	[GOOSC]	G OOS C
GOOSI	[GOOSI]	G OOSI
GOOSM	[GOOSM]	G OOS M
GOOF	[GOOF]	G OOF
GOOFM	[GOOFM]	G OOF M
GOOFNG	[GOOFNG]	G OOF NG
GOOR	[GOOR]	G OOR
GOOX	[GOOX]	G OOX
GOOJI	[GOOJI]	G OOJI
GOOJP	[GOOJP]	G OOJ P
GOWSM	[GOWSM]	G OWS M
GOWFM	[GOWFM]	G OWF M
GOWRI	[GOWRI]	G OWRI
GOWX	[GOWX]	G OWX
GOWJI	[GOWJI]	G OWJI
GOWJN	[GOWJN]	G OWJ N
GOWJT	[GOWJT]	G OWJ T
GUJC	[GUJC]	G UJ C
GUWRI	[GUWRI]	G UWRI
H	[H]	H 
HA	[HA]	H A
HAI	[HAI]	H AI
HAM	[HAM]	H A M
HAN	[HAN]	H A N
HANG	[HANG]	H A NG
HAO	[HAO]	H AO
HAY	[HAY]	H AY
HE	[HE]	H E
HEM	[HEM]	H E M
HEN	[HEN]	H E N
HEO	[HEO]	H EO
HI	[HI]	H I
HIA	[HIA]	H IA
HIU	[HIU]	H IU
HIEEN	[HIEEN]	H IEE N
HIEENG	[HIEENG]	H IEE NG
HIEESM	[HIEESM]	H IEES M
HIEESN	[HIEESN]	H IEES N
HIEESP	[HIEESP]	H IEES P
HIEESU	[HIEESU]	H IEESU
HIEEFN	[HIEEFN]	H IEEF N
HIEERM	[HIEERM]	H IEER M
HIEERN	[HIEERN]	H IEER N
HIEERU	[HIEERU]	H IEERU
HIEEJN	[HIEEJN]	H IEEJ N
HIEEJP	[HIEEJP]	H IEEJ P
HIEEJU	[HIEEJU]	H IEEJU
HO	[HO]	H O
HOA	[HOA]	H OA
HOAN	[HOAN]	H OA N
HOANG	[HOANG]	H OA NG
HOAY	[HOAY]	H OAY
HOI	[HOI]	H OI
HOM	[HOM]	H O M
HOAF	[HOAF]	H OAF
HOAFI	[HOAFI]	H OAFI
HOAFN	[HOAFN]	H OAF N
HOAFNG	[HOAFNG]	H OAF NG
HOAFNH	[HOAFNH]	H OAF NH
HOAS	[HOAS]	H OAS
HOASC	[HOASC]	H OAS C
HOAXN	[HOAXN]	H OAX N
HOEST	[HOEST]	H OES T
HOAJ	[HOAJ]	H OAJ
HOAJCH	[HOAJCH]	H OAJ CH
HOAJI	[HOAJI]	H OAJI
HOAJN	[HOAJN]	H OAJ N
HOAJT	[HOAJT]	H OAJ T
HOARNG	[HOARNG]	H OAR NG
HOAWSC	[HOAWSC]	H OAWS C
HOAWST	[HOAWST]	H OAWS T
HOAWRN	[HOAWRN]	H OAWR N
HOAWJC	[HOAWJC]	H OAWJ C
HU	[HU]	H U
HUN	[HUN]	H U N
HUNG	[HUNG]	H U NG
HUY	[HUY]	H UY
HUYNH	[HUYNH]	H UY NH
HUYEEN	[HUYEEN]	H UYEE N
HUYEEST	[HUYEEST]	H UYEES T
HUYEEFN	[HUYEEFN]	H UYEEF N
HUYEEXN	[HUYEEXN]	H UYEEX N
HUYEEJN	[HUYEEJN]	H UYEEJ N
HUYEEJT	[HUYEEJT]	H UYEEJ T
HUAAN	[HUAAN]	H UAA N
HUEE	[HUEE]	H UEE
HUYST	[HUYST]	H UYS T
HUOW	[HUOW]	H UOW
HUAASN	[HUAASN]	H UAAS N
HUEES	[HUEES]	H UEES
HUEESCH	[HUEESCH]	H UEES CH
HUEEF	[HUEEF]	H UEEF
HUEEJ	[HUEEJ]	H UEEJ
HUOOSNG	[HUOOSNG]	H UOOS NG
HUYFNH	[HUYFNH]	H UYF NH
HUYR	[HUYR]	H UYR
HY	[HY]	H Y
HAF	[HAF]	H AF
HAFI	[HAFI]	H AFI
HAFM	[HAFM]	H AF M
HAFN	[HAFN]	H AF N
HAFNG	[HAFNG]	H AF NG
HAFNH	[HAFNH]	H AF NH
HAFO	[HAFO]	H AFO
HAFU	[HAFU]	H AFU
HAS	[HAS]	H AS
HASI	[HASI]	H ASI
HASM	[HASM]	H AS M
HASN	[HASN]	H AS N
HASNG	[HASNG]	H AS NG
HASO	[HASO]	H ASO
HAST	[HAST]	H AS T
HAAM	[HAAM]	H AA M
HAAN	[HAAN]	H AA N
HAXI	[HAXI]	H AXI
HAXN	[HAXN]	H AX N
HAXNG	[HAXNG]	H AX NG
HAXNH	[HAXNH]	H AX NH
HAXO	[HAXO]	H AXO
HAXY	[HAXY]	H AXY
HEF	[HEF]	H EF
HEFN	[HEFN]	H EF N
HES	[HES]	H ES
HESO	[HESO]	H ESO
HEST	[HEST]	H ES T
HEEN	[HEEN]	H EE N
HEENH	[HEENH]	H EE NH
HIF	[HIF]	H IF
HIFNH	[HIFNH]	H IF NH
HIS	[HIS]	H IS
HIST	[HIST]	H IS T
HOF	[HOF]	H OF
HOFA	[HOFA]	H OFA
HOFN	[HOFN]	H OF N
HOSA	[HOSA]	H OSA
HOSC	[HOSC]	H OS C
HOSI	[HOSI]	H OSI
HOSM	[HOSM]	H OS M
HOSNG	[HOSNG]	H OS NG
HOST	[HOST]	H OS T
HOO	[HOO]	H OO
HOOI	[HOOI]	H OOI
HOOM	[HOOM]	H OO M
HOON	[HOON]	H OO N
HOONG	[HOONG]	H OO NG
HUFA	[HUFA]	H UFA
HUFN	[HUFN]	H UF N
HUFNG	[HUFNG]	H UF NG
HUS	[HUS]	H US
HUSC	[HUSC]	H US C
HUSI	[HUSI]	H USI
HUSNG	[HUSNG]	H US NG
HUSP	[HUSP]	H US P
HUST	[HUST]	H US T
HUSY	[HUSY]	H USY
HAWM	[HAWM]	H AW M
HAWNG	[HAWNG]	H AW NG
HIXNH	[HIXNH]	H IX NH
HUX	[HUX]	H UX
HUXM	[HUXM]	H UX M
HOWI	[HOWI]	H OWI
HOWN	[HOWN]	H OW N
HUW	[HUW]	H UW
HUWNG	[HUWNG]	H UW NG
HUWU	[HUWU]	H UWU
HUWOWNG	[HUWOWNG]	H UWOW NG
HUWOWU	[HUWOWU]	H UWOWU
HUWOWSC	[HUWOWSC]	H UWOWS C
HUWOWSM	[HUWOWSM]	H UWOWS M
HUWOWSNG	[HUWOWSNG]	H UWOWS NG
HUWOWFNG	[HUWOWFNG]	H UWOWF NG
HUWOWRNG	[HUWOWRNG]	H UWOWR NG
HAJ	[HAJ]	H AJ
HAJC	[HAJC]	H AJ C
HAJCH	[HAJCH]	H AJ CH
HAJI	[HAJI]	H AJI
HAJM	[HAJM]	H AJ M
HAJN	[HAJN]	H AJ N
HAJNG	[HAJNG]	H AJ NG
HAJNH	[HAJNH]	H AJ NH
HAJO	[HAJO]	H AJO
HAJP	[HAJP]	H AJ P
HAJT	[HAJT]	H AJ T
HAR	[HAR]	H AR
HARI	[HARI]	H ARI
HARM	[HARM]	H AR M
HARO	[HARO]	H ARO
HAASNG	[HAASNG]	H AAS NG
HAASP	[HAASP]	H AAS P
HAAST	[HAAST]	H AAS T
HAASU	[HAASU]	H AASU
HAAFM	[HAAFM]	H AAF M
HAAFU	[HAAFU]	H AAFU
HAAFY	[HAAFY]	H AAFY
HAARM	[HAARM]	H AAR M
HAAXNG	[HAAXNG]	H AAX NG
HAAJN	[HAAJN]	H AAJ N
HAAJP	[HAAJP]	H AAJ P
HAAJU	[HAAJU]	H AAJU
HAWSC	[HAWSC]	H AWS C
HAWSN	[HAWSN]	H AWS N
HAWSNG	[HAWSNG]	H AWS NG
HAWST	[HAWST]	H AWS T
HAWFN	[HAWFN]	H AWF N
HAWFNG	[HAWFNG]	H AWF NG
HAWRN	[HAWRN]	H AWR N
HAWXNG	[HAWXNG]	H AWX NG
HAWJC	[HAWJC]	H AWJ C
HEJ	[HEJ]	H EJ
HEJN	[HEJN]	H EJ N
HEJP	[HEJP]	H EJ P
HERM	[HERM]	H ER M
HEESN	[HEESN]	H EES N
HEEST	[HEEST]	H EES T
HEEF	[HEEF]	H EEF
HEER	[HEER]	H EER
HEERN	[HEERN]	H EER N
HEERNH	[HEERNH]	H EER NH
HEEX	[HEEX]	H EEX
HEEJ	[HEEJ]	H EEJ
HEEJT	[HEEJT]	H EEJ T
HIR	[HIR]	H IR
HIRNH	[HIRNH]	H IR NH
HOJ	[HOJ]	H OJ
HOJA	[HOJA]	H OJA
HOJC	[HOJC]	H OJ C
HOJNG	[HOJNG]	H OJ NG
HOJP	[HOJP]	H OJ P
HORA	[HORA]	H ORA
HORI	[HORI]	H ORI
HORM	[HORM]	H OR M
HORNG	[HORNG]	H OR NG
HOOS	[HOOS]	H OOS
HOOSC	[HOOSC]	H OOS C
HOOSI	[HOOSI]	H OOSI
HOOST	[HOOST]	H OOS T
HOOF	[HOOF]	H OOF
HOOFI	[HOOFI]	H OOFI
HOOFN	[HOOFN]	H OOF N
HOOFNG	[HOOFNG]	H OOF NG
HOOR	[HOOR]	H OOR
HOORI	[HOORI]	H OORI
HOORM	[HOORM]	H OOR M
HOORN	[HOORN]	H OOR N
HOORNG	[HOORNG]	H OOR NG
HOOX	[HOOX]	H OOX
HOOXN	[HOOXN]	H OOX N
HOOJ	[HOOJ]	H OOJ
HOOJC	[HOOJC]	H OOJ C
HOOJI	[HOOJI]	H OOJI
HOOJN	[HOOJN]	H OOJ N
HOOJP	[HOOJP]	H OOJ P
HOOJT	[HOOJT]	H OOJ T
HOWS	[HOWS]	H OWS
HOWSN	[HOWSN]	H OWS N
HOWSP	[HOWSP]	H OWS P
HOWST	[HOWST]	H OWS T
HOWFN	[HOWFN]	H OWF N
HOWR	[HOWR]	H OWR
HOWRI	[HOWRI]	H OWRI
HOWJI	[HOWJI]	H OWJI
HOWJM	[HOWJM]	H OWJ M
HOWJP	[HOWJP]	H OWJ P
HUJ	[HUJ]	H UJ
HUJC	[HUJC]	H UJ C
HUJI	[HUJI]	H UJI
HUJT	[HUJT]	H UJ T
HUR	[HUR]	H UR
HURY	[HURY]	H URY
HUWSA	[HUWSA]	H UWSA
HUWSC	[HUWSC]	H UWS C
HUWSNG	[HUWSNG]	H UWS NG
HUWF	[HUWF]	H UWF
HUWFNG	[HUWFNG]	H UWF NG
HUWXU	[HUWXU]	H UWXU
HUWJ	[HUWJ]	H UWJ
HUWJC	[HUWJC]	H UWJ C
HUWJU	[HUWJU]	H UWJU
I	[I]	I
IM	[IM]	I M
IN	[IN]	I N
INH	[INH]	I NH
K	[K]	K 
KA	[KA]	K A
KEM	[KEM]	K E M
KEN	[KEN]	K E N
KEO	[KEO]	K EO
KHA	[KHA]	KH A
KHAI	[KHAI]	KH AI
KHAN	[KHAN]	KH A N
KHANG	[KHANG]	KH A NG
KHANH	[KHANH]	KH A NH
KHAO	[KHAO]	KH AO
KHE	[KHE]	KH E
KHEN	[KHEN]	KH E N
KHEO	[KHEO]	KH EO
KHI	[KHI]	KH I
KHINH	[KHINH]	KH I NH
KHIEEM	[KHIEEM]	KH IEE M
KHIEEN	[KHIEEN]	KH IEE N
KHIEENG	[KHIEENG]	KH IEE NG
KHIEEU	[KHIEEU]	KH IEEU
KHIEESM	[KHIEESM]	KH IEES M
KHIEESN	[KHIEESN]	KH IEES N
KHIEESP	[KHIEESP]	KH IEES P
KHIEEST	[KHIEEST]	KH IEES T
KHIEESU	[KHIEESU]	KH IEESU
KHIEERN	[KHIEERN]	KH IEER N
KHO	[KHO]	KH O
KHOA	[KHOA]	KH OA
KHOAI	[KHOAI]	KH OAI
KHOAN	[KHOAN]	KH OA N
KHOANG	[KHOANG]	KH OA NG
KHOANH	[KHOANH]	KH OA NH
KHOE	[KHOE]	KH OE
KHOM	[KHOM]	KH O M
KHOAS	[KHOAS]	KH OAS
KHOASC	[KHOASC]	KH OAS C
KHOASI	[KHOASI]	KH OASI
KHOASN	[KHOASN]	KH OAS N
KHOAST	[KHOAST]	KH OAS T
KHOEFO	[KHOEFO]	KH OEFO
KHOEST	[KHOEST]	KH OES T
KHOAWN	[KHOAWN]	KH OAW N
KHOARI	[KHOARI]	KH OARI
KHOARN	[KHOARN]	KH OAR N
KHOARNG	[KHOARNG]	KH OAR NG
KHOARNH	[KHOARNH]	KH OAR NH
KHOAWST	[KHOAWST]	KH OAWS T
KHOER	[KHOER]	KH OER
KHU	[KHU]	KH U
KHUA	[KHUA]	KH UA
KHUM	[KHUM]	KH U M
KHUNG	[KHUNG]	KH U NG
KHUY	[KHUY]	KH UY
KHUYA	[KHUYA]	KH UYA
KHUYNH	[KHUYNH]	KH UY NH
KHUYEEN	[KHUYEEN]	KH UYEE N
KHUYEESN	[KHUYEESN]	KH UYEES N
KHUYEEST	[KHUYEEST]	KH UYEES T
KHUAAN	[KHUAAN]	KH UAA N
KHUAANG	[KHUAANG]	KH UAA NG
KHUAAY	[KHUAAY]	KH UAAY
KHUOON	[KHUOON]	KH UOO N
KHUAAST	[KHUAAST]	KH UAAS T
KHUAASY	[KHUAASY]	KH UAASY
KHUAARN	[KHUAARN]	KH UAAR N
KHUYFNH	[KHUYFNH]	KH UYF NH
KHUYRU	[KHUYRU]	KH UYRU
KHAFN	[KHAFN]	KH AF N
KHAFNG	[KHAFNG]	KH AF NG
KHAS	[KHAS]	KH AS
KHASC	[KHASC]	KH AS C
KHASCH	[KHASCH]	KH AS CH
KHASI	[KHASI]	KH ASI
KHASM	[KHASM]	KH AS M
KHASN	[KHASN]	KH AS N
KHASNG	[KHASNG]	KH AS NG
KHASNH	[KHASNH]	KH AS NH
KHASO	[KHASO]	KH ASO
KHASP	[KHASP]	KH AS P
KHAST	[KHAST]	KH AS T
KHAAM	[KHAAM]	KH AA M
KHAAU	[KHAAU]	KH AAU
KHEF	[KHEF]	KH EF
KHEFN	[KHEFN]	KH EF N
KHEFO	[KHEFO]	KH EFO
KHESN	[KHESN]	KH ES N
KHESO	[KHESO]	KH ESO
KHESP	[KHESP]	KH ES P
KHEST	[KHEST]	KH ES T
KHEE	[KHEE]	KH EE
KHIS	[KHIS]	KH IS
KHISA	[KHISA]	KH ISA
KHISCH	[KHISCH]	KH IS CH
KHIST	[KHIST]	KH IS T
KHISU	[KHISU]	KH ISU
KHOF	[KHOF]	KH OF
KHOS	[KHOS]	KH OS
KHOSA	[KHOSA]	KH OSA
KHOSC	[KHOSC]	KH OS C
KHOSE	[KHOSE]	KH OSE
KHOSI	[KHOSI]	KH OSI
KHOO	[KHOO]	KH OO
KHOOI	[KHOOI]	KH OOI
KHOON	[KHOON]	KH OO N
KHOONG	[KHOONG]	KH OO NG
KHUF	[KHUF]	KH UF
KHUS	[KHUS]	KH US
KHUSC	[KHUSC]	KH US C
KHUSM	[KHUSM]	KH US M
KHAWM	[KHAWM]	KH AW M
KHAWN	[KHAWN]	KH AW N
KHOW	[KHOW]	KH OW
KHOWI	[KHOWI]	KH OWI
KHUW	[KHUW]	KH UW
KHUWOWM	[KHUWOWM]	KH UWOW M
KHUWOWN	[KHUWOWN]	KH UWOW N
KHUWOWNG	[KHUWOWNG]	KH UWOW NG
KHUWOWSC	[KHUWOWSC]	KH UWOWS C
KHAJC	[KHAJC]	KH AJ C
KHAJNG	[KHAJNG]	KH AJ NG
KHAR	[KHAR]	KH AR
KHARI	[KHARI]	KH ARI
KHARO	[KHARO]	KH ARO
KHARY	[KHARY]	KH ARY
KHAASN	[KHAASN]	KH AAS N
KHAASP	[KHAASP]	KH AAS P
KHAAST	[KHAAST]	KH AAS T
KHAASU	[KHAASU]	KH AASU
KHAARN	[KHAARN]	KH AAR N
KHAARU	[KHAARU]	KH AARU
KHAAJT	[KHAAJT]	KH AAJ T
KHAWSC	[KHAWSC]	KH AWS C
KHAWSM	[KHAWSM]	KH AWS M
KHAWSNG	[KHAWSNG]	KH AWS NG
KHAWSP	[KHAWSP]	KH AWS P
KHAWST	[KHAWST]	KH AWS T
KHAWRM	[KHAWRM]	KH AWR M
KHAWRNG	[KHAWRNG]	KH AWR NG
KHER	[KHER]	KH ER
KHEX	[KHEX]	KH EX
KHEES	[KHEES]	KH EES
KHEEFU	[KHEEFU]	KH EEFU
KHEEJ	[KHEEJ]	KH EEJ
KHEEJNH	[KHEEJNH]	KH EEJ NH
KHIR	[KHIR]	KH IR
KHIJT	[KHIJT]	KH IJ T
KHORA	[KHORA]	KH ORA
KHORE	[KHORE]	KH ORE
KHORI	[KHORI]	KH ORI
KHOOS	[KHOOS]	KH OOS
KHOOSC	[KHOOSC]	KH OOS C
KHOOSI	[KHOOSI]	KH OOSI
KHOOSN	[KHOOSN]	KH OOS N
KHOOSNG	[KHOOSNG]	KH OOS NG
KHOOR	[KHOOR]	KH OOR
KHOORNG	[KHOORNG]	KH OOR NG
KHOWS	[KHOWS]	KH OWS
KHOWSP	[KHOWSP]	KH OWS P
KHOWF	[KHOWF]	KH OWF
KHOWRI	[KHOWRI]	KH OWRI
KHUJ	[KHUJ]	KH UJ
KHURNG	[KHURNG]	KH UR NG
KHUWS	[KHUWS]	KH UWS
KHUWSU	[KHUWSU]	KH UWSU
KHUWF	[KHUWF]	KH UWF
KHUWJNG	[KHUWJNG]	KH UWJ NG
KI	[KI]	K I
KIA	[KIA]	K IA
KIM	[KIM]	K I M
KINH	[KINH]	K I NH
KIEEM	[KIEEM]	K IEE M
KIEEN	[KIEEN]	K IEE N
KIEENG	[KIEENG]	K IEE NG
KIEEU	[KIEEU]	K IEEU
KIEESM	[KIEESM]	K IEES M
KIEESN	[KIEESN]	K IEES N
KIEESP	[KIEESP]	K IEES P
KIEEFM	[KIEEFM]	K IEEF M
KIEEFN	[KIEEFN]	K IEEF N
KIEEFNG	[KIEEFNG]	K IEEF NG
KIEEFU	[KIEEFU]	K IEEFU
KIEERM	[KIEERM]	K IEER M
KIEERNG	[KIEERNG]	K IEER NG
KIEERU	[KIEERU]	K IEERU
KIEEJM	[KIEEJM]	K IEEJ M
KIEEJN	[KIEEJN]	K IEEJ N
KIEEJT	[KIEEJT]	K IEEJ T
KIEEJU	[KIEEJU]	K IEEJU
KO	[KO]	K O
KY	[KY]	K Y
KEF	[KEF]	K EF
KEFM	[KEFM]	K EF M
KEFN	[KEFN]	K EF N
KEFO	[KEFO]	K EFO
KESM	[KESM]	K ES M
KESN	[KESN]	K ES N
KESO	[KESO]	K ESO
KESP	[KESP]	K ES P
KEST	[KEST]	K ES T
KEE	[KEE]	K EE
KEENH	[KEENH]	K EE NH
KEEU	[KEEU]	K EEU
KIF	[KIF]	K IF
KIFA	[KIFA]	K IFA
KIFM	[KIFM]	K IF M
KIFNH	[KIFNH]	K IF NH
KIS	[KIS]	K IS
KISCH	[KISCH]	K IS CH
KISN	[KISN]	K IS N
KISNH	[KISNH]	K IS NH
KISP	[KISP]	K IS P
KIST	[KIST]	K IS T
KYS	[KYS]	K YS
KIX	[KIX]	K IX
KEJN	[KEJN]	K EJ N
KEJO	[KEJO]	K EJO
KEJP	[KEJP]	K EJ P
KEJT	[KEJT]	K EJ T
KER	[KER]	K ER
KERNG	[KERNG]	K ER NG
KERO	[KERO]	K ERO
KEX	[KEX]	K EX
KEXM	[KEXM]	K EX M
KEXO	[KEXO]	K EXO
KEES	[KEES]	K EES
KEESCH	[KEESCH]	K EES CH
KEEST	[KEEST]	K EES T
KEEF	[KEEF]	K EEF
KEEFN	[KEEFN]	K EEF N
KEEFNH	[KEEFNH]	K EEF NH
KEER	[KEER]	K EER
KEEJ	[KEEJ]	K EEJ
KEEJNH	[KEEJNH]	K EEJ NH
KIR	[KIR]	K IR
KIRNH	[KIRNH]	K IR NH
KIJ	[KIJ]	K IJ
KIJCH	[KIJCH]	K IJ CH
KIJP	[KIJP]	K IJ P
KIJT	[KIJT]	K IJ T
KYF	[KYF]	K YF
KYJ	[KYJ]	K YJ
KYR	[KYR]	K YR
KYX	[KYX]	K YX
LA	[LA]	L A
LAI	[LAI]	L AI
LAM	[LAM]	L A M
LAN	[LAN]	L A N
LANG	[LANG]	L A NG
LANH	[LANH]	L A NH
LAO	[LAO]	L AO
LAU	[LAU]	L AU
LAY	[LAY]	L AY
LE	[LE]	L E
LEM	[LEM]	L E M
LEN	[LEN]	L E N
LEO	[LEO]	L EO
LI	[LI]	L I
LIA	[LIA]	L IA
LIM	[LIM]	L I M
LIN	[LIN]	L I N
LINH	[LINH]	L I NH
LIU	[LIU]	L IU
LIEEM	[LIEEM]	L IEE M
LIEEN	[LIEEN]	L IEE N
LIEENG	[LIEENG]	L IEE NG
LIEEU	[LIEEU]	L IEEU
LIEESC	[LIEESC]	L IEES C
LIEESM	[LIEESM]	L IEES M
LIEESN	[LIEESN]	L IEES N
LIEESNG	[LIEESNG]	L IEES NG
LIEEFM	[LIEEFM]	L IEEF M
LIEEFN	[LIEEFN]	L IEEF N
LIEEFU	[LIEEFU]	L IEEFU
LIEEXU	[LIEEXU]	L IEEXU
LIEEJNG	[LIEEJNG]	L IEEJ NG
LIEEJT	[LIEEJT]	L IEEJ T
LIEEJU	[LIEEJU]	L IEEJU
LO	[LO]	L O
LOA	[LOA]	L OA
LOAN	[LOAN]	L OA N
LOANH	[LOANH]	L OA NH
LOAY	[LOAY]	L OAY
LOI	[LOI]	L OI
LOM	[LOM]	L O M
LONG	[LONG]	L O NG
LOAFI	[LOAFI]	L OAFI
LOAFN	[LOAFN]	L OAF N
LOAFNG	[LOAFNG]	L OAF NG
LOAXNG	[LOAXNG]	L OAX NG
LOES	[LOES]	L OES
LOEST	[LOEST]	L OES T
LOAJI	[LOAJI]	L OAJI
LOAJN	[LOAJN]	L OAJ N
LOAJNG	[LOAJNG]	L OAJ NG
LOAJT	[LOAJT]	L OAJ T
LOARNG	[LOARNG]	L OAR NG
LOAWST	[LOAWST]	L OAWS T
LOAWFNG	[LOAWFNG]	L OAWF NG
LU	[LU]	L U
LUI	[LUI]	L UI
LUNG	[LUNG]	L U NG
LUYEESN	[LUYEESN]	L UYEES N
LUYEEJN	[LUYEEJN]	L UYEEJ N
LUAAN	[LUAAN]	L UAA N
LUOON	[LUOON]	L UOO N
LUAARN	[LUAARN]	L UAAR N
LUAAJN	[LUAAJN]	L UAAJ N
LUAAJT	[LUAAJT]	L UAAJ T
LUOOSNG	[LUOOSNG]	L UOOS NG
LUOOFN	[LUOOFN]	L UOOF N
LUOOFNG	[LUOOFNG]	L UOOF NG
LUOOXNG	[LUOOXNG]	L UOOX NG
LUOOJC	[LUOOJC]	L UOOJ C
LY	[LY]	L Y
LAF	[LAF]	L AF
LAFI	[LAFI]	L AFI
LAFM	[LAFM]	L AF M
LAFN	[LAFN]	L AF N
LAFNG	[LAFNG]	L AF NG
LAFNH	[LAFNH]	L AF NH
LAFO	[LAFO]	L AFO
LAFU	[LAFU]	L AFU
LAS	[LAS]	L AS
LASC	[LASC]	L AS C
LASCH	[LASCH]	L AS CH
LASI	[LASI]	L ASI
LASNG	[LASNG]	L AS NG
LASNH	[LASNH]	L AS NH
LASO	[LASO]	L ASO
LASP	[LASP]	L AS P
LAST	[LAST]	L AS T
LASU	[LASU]	L ASU
LASY	[LASY]	L ASY
LAAM	[LAAM]	L AA M
LAAN	[LAAN]	L AA N
LAANG	[LAANG]	L AA NG
LAAU	[LAAU]	L AAU
LAAY	[LAAY]	L AAY
LAX	[LAX]	L AX
LAXI	[LAXI]	L AXI
LAXM	[LAXM]	L AX M
LAXN	[LAXN]	L AX N
LAXNG	[LAXNG]	L AX NG
LAXNH	[LAXNH]	L AX NH
LAXO	[LAXO]	L AXO
LEF	[LEF]	L EF
LEFO	[LEFO]	L EFO
LES	[LES]	L ES
LESC	[LESC]	L ES C
LESM	[LESM]	L ES M
LESN	[LESN]	L ES N
LESNG	[LESNG]	L ES NG
LESO	[LESO]	L ESO
LESP	[LESP]	L ES P
LEST	[LEST]	L ES T
LEE	[LEE]	L EE
LEEN	[LEEN]	L EE N
LEENH	[LEENH]	L EE NH
LEEU	[LEEU]	L EEU
LIF	[LIF]	L IF
LIFA	[LIFA]	L IFA
LIFM	[LIFM]	L IF M
LIS	[LIS]	L IS
LISNH	[LISNH]	L IS NH
LISP	[LISP]	L IS P
LIST	[LIST]	L IS T
LISU	[LISU]	L ISU
LOF	[LOF]	L OF
LOFA	[LOFA]	L OFA
LOFI	[LOFI]	L OFI
LOFM	[LOFM]	L OF M
LOFNG	[LOFNG]	L OF NG
LOSC	[LOSC]	L OS C
LOSE	[LOSE]	L OSE
LOSM	[LOSM]	L OS M
LOSNG	[LOSNG]	L OS NG
LOST	[LOST]	L OS T
LOO	[LOO]	L OO
LOOI	[LOOI]	L OOI
LOOM	[LOOM]	L OO M
LOONG	[LOONG]	L OO NG
LOXI	[LOXI]	L OXI
LOXM	[LOXM]	L OX M
LOXNG	[LOXNG]	L OX NG
LUF	[LUF]	L UF
LUFA	[LUFA]	L UFA
LUFI	[LUFI]	L UFI
LUFM	[LUFM]	L UF M
LUFNG	[LUFNG]	L UF NG
LUS	[LUS]	L US
LUSA	[LUSA]	L USA
LUSC	[LUSC]	L US C
LUSI	[LUSI]	L USI
LUSM	[LUSM]	L US M
LUSN	[LUSN]	L US N
LUSNG	[LUSNG]	L US NG
LYS	[LYS]	L YS
LAWM	[LAWM]	L AW M
LAWN	[LAWN]	L AW N
LAWNG	[LAWNG]	L AW NG
LIXNH	[LIXNH]	L IX NH
LUX	[LUX]	L UX
LUXI	[LUXI]	L UXI
LUXM	[LUXM]	L UX M
LUXN	[LUXN]	L UX N
LUXNG	[LUXNG]	L UX NG
LUXY	[LUXY]	L UXY
LOW	[LOW]	L OW
LOWI	[LOWI]	L OWI
LOWN	[LOWN]	L OW N
LUW	[LUW]	L UW
LUWNG	[LUWNG]	L UW NG
LUWU	[LUWU]	L UWU
LUWOWM	[LUWOWM]	L UWOW M
LUWOWN	[LUWOWN]	L UWOW N
LUWOWNG	[LUWOWNG]	L UWOW NG
LUWOWSI	[LUWOWSI]	L UWOWSI
LUWOWSNG	[LUWOWSNG]	L UWOWS NG
LUWOWST	[LUWOWST]	L UWOWS T
LUWOWFI	[LUWOWFI]	L UWOWFI
LUWOWFNG	[LUWOWFNG]	L UWOWF NG
LUWOWXI	[LUWOWXI]	L UWOWXI
LUWOWXNG	[LUWOWXNG]	L UWOWX NG
LUWOWJC	[LUWOWJC]	L UWOWJ C
LUWOWJM	[LUWOWJM]	L UWOWJ M
LUWOWJN	[LUWOWJN]	L UWOWJ N
LUWOWJNG	[LUWOWJNG]	L UWOWJ NG
LUWOWJT	[LUWOWJT]	L UWOWJ T
LAJ	[LAJ]	L AJ
LAJC	[LAJC]	L AJ C
LAJCH	[LAJCH]	L AJ CH
LAJI	[LAJI]	L AJI
LAJM	[LAJM]	L AJ M
LAJN	[LAJN]	L AJ N
LAJNG	[LAJNG]	L AJ NG
LAJNH	[LAJNH]	L AJ NH
LAJO	[LAJO]	L AJO
LAJP	[LAJP]	L AJ P
LAJT	[LAJT]	L AJ T
LAJY	[LAJY]	L AJY
LAR	[LAR]	L AR
LARI	[LARI]	L ARI
LARM	[LARM]	L AR M
LARNG	[LARNG]	L AR NG
LARNH	[LARNH]	L AR NH
LAASM	[LAASM]	L AAS M
LAASN	[LAASN]	L AAS N
LAASP	[LAASP]	L AAS P
LAAST	[LAAST]	L AAS T
LAASY	[LAASY]	L AASY
LAAFM	[LAAFM]	L AAF M
LAAFN	[LAAFN]	L AAF N
LAAFU	[LAAFU]	L AAFU
LAAFY	[LAAFY]	L AAFY
LAARM	[LAARM]	L AAR M
LAARN	[LAARN]	L AAR N
LAARU	[LAARU]	L AARU
LAAXN	[LAAXN]	L AAX N
LAAXY	[LAAXY]	L AAXY
LAAJN	[LAAJN]	L AAJ N
LAAJP	[LAAJP]	L AAJ P
LAAJT	[LAAJT]	L AAJ T
LAAJU	[LAAJU]	L AAJU
LAWSC	[LAWSC]	L AWS C
LAWSM	[LAWSM]	L AWS M
LAWSNG	[LAWSNG]	L AWS NG
LAWSP	[LAWSP]	L AWS P
LAWST	[LAWST]	L AWS T
LAWFN	[LAWFN]	L AWF N
LAWFNG	[LAWFNG]	L AWF NG
LAWRM	[LAWRM]	L AWR M
LAWRN	[LAWRN]	L AWR N
LAWRNG	[LAWRNG]	L AWR NG
LAWJM	[LAWJM]	L AWJ M
LAWJN	[LAWJN]	L AWJ N
LAWJNG	[LAWJNG]	L AWJ NG
LAWJP	[LAWJP]	L AWJ P
LAWJT	[LAWJT]	L AWJ T
LEJ	[LEJ]	L EJ
LEJM	[LEJM]	L EJ M
LER	[LER]	L ER
LERN	[LERN]	L ER N
LERNG	[LERNG]	L ER NG
LEX	[LEX]	L EX
LEXN	[LEXN]	L EX N
LEXO	[LEXO]	L EXO
LEEST	[LEEST]	L EES T
LEESU	[LEESU]	L EESU
LEEF	[LEEF]	L EEF
LEEFNH	[LEEFNH]	L EEF NH
LEEFU	[LEEFU]	L EEFU
LEER	[LEER]	L EER
LEEX	[LEEX]	L EEX
LEEJ	[LEEJ]	L EEJ
LEEJCH	[LEEJCH]	L EEJ CH
LEEJNH	[LEEJNH]	L EEJ NH
LIRNH	[LIRNH]	L IR NH
LIJA	[LIJA]	L IJA
LIJCH	[LIJCH]	L IJ CH
LIJM	[LIJM]	L IJ M
LIJNH	[LIJNH]	L IJ NH
LOJ	[LOJ]	L OJ
LOJC	[LOJC]	L OJ C
LOJNG	[LOJNG]	L OJ NG
LOJT	[LOJT]	L OJ T
LORI	[LORI]	L ORI
LORN	[LORN]	L OR N
LORNG	[LORNG]	L OR NG
LOOS	[LOOS]	L OOS
LOOSC	[LOOSC]	L OOS C
LOOSI	[LOOSI]	L OOSI
LOOSM	[LOOSM]	L OOS M
LOOSP	[LOOSP]	L OOS P
LOOST	[LOOST]	L OOS T
LOOF	[LOOF]	L OOF
LOOFI	[LOOFI]	L OOFI
LOOFM	[LOOFM]	L OOF M
LOOFNG	[LOOFNG]	L OOF NG
LOORM	[LOORM]	L OOR M
LOORNG	[LOORNG]	L OOR NG
LOOX	[LOOX]	L OOX
LOOXI	[LOOXI]	L OOXI
LOOJ	[LOOJ]	L OOJ
LOOJC	[LOOJC]	L OOJ C
LOOJI	[LOOJI]	L OOJI
LOOJN	[LOOJN]	L OOJ N
LOOJNG	[LOOJNG]	L OOJ NG
LOOJP	[LOOJP]	L OOJ P
LOOJT	[LOOJT]	L OOJ T
LOWSN	[LOWSN]	L OWS N
LOWSP	[LOWSP]	L OWS P
LOWST	[LOWST]	L OWS T
LOWF	[LOWF]	L OWF
LOWFI	[LOWFI]	L OWFI
LOWFM	[LOWFM]	L OWF M
LOWFN	[LOWFN]	L OWF N
LOWR	[LOWR]	L OWR
LOWRI	[LOWRI]	L OWRI
LOWRN	[LOWRN]	L OWR N
LOWX	[LOWX]	L OWX
LOWXM	[LOWXM]	L OWX M
LOWJI	[LOWJI]	L OWJI
LOWJM	[LOWJM]	L OWJ M
LOWJN	[LOWJN]	L OWJ N
LOWJP	[LOWJP]	L OWJ P
LUJ	[LUJ]	L UJ
LUJA	[LUJA]	L UJA
LUJC	[LUJC]	L UJ C
LUJNG	[LUJNG]	L UJ NG
LUJT	[LUJT]	L UJ T
LUR	[LUR]	L UR
LURI	[LURI]	L URI
LURM	[LURM]	L UR M
LURNG	[LURNG]	L UR NG
LUWSA	[LUWSA]	L UWSA
LUWSC	[LUWSC]	L UWS C
LUWST	[LUWST]	L UWS T
LUWF	[LUWF]	L UWF
LUWFA	[LUWFA]	L UWFA
LUWFNG	[LUWFNG]	L UWF NG
LUWR	[LUWR]	L UWR
LUWRA	[LUWRA]	L UWRA
LUWRNG	[LUWRNG]	L UWR NG
LUWX	[LUWX]	L UWX
LUWXA	[LUWXA]	L UWXA
LUWXNG	[LUWXNG]	L UWX NG
LUWJA	[LUWJA]	L UWJA
LUWJC	[LUWJC]	L UWJ C
LUWJU	[LUWJU]	L UWJU
LYJ	[LYJ]	L YJ
M	[M]	M 
MA	[MA]	M A
MAI	[MAI]	M AI
MAN	[MAN]	M A N
MANG	[MANG]	M A NG
MANH	[MANH]	M A NH
MAU	[MAU]	M AU
MAY	[MAY]	M AY
ME	[ME]	M E
MEN	[MEN]	M E N
MI	[MI]	M I
MIN	[MIN]	M I N
MINH	[MINH]	M I NH
MIEEN	[MIEEN]	M IEE N
MIEEU	[MIEEU]	M IEEU
MIEESNG	[MIEESNG]	M IEES NG
MIEEST	[MIEEST]	M IEES T
MIEESU	[MIEESU]	M IEESU
MIEEFN	[MIEEFN]	M IEEF N
MIEEFU	[MIEEFU]	M IEEFU
MIEEXN	[MIEEXN]	M IEEX N
MIEEJN	[MIEEJN]	M IEEJ N
MIEEJNG	[MIEEJNG]	M IEEJ NG
MIEEJT	[MIEEJT]	M IEEJ T
MO	[MO]	M O
MONG	[MONG]	M O NG
MU	[MU]	M U
MUA	[MUA]	M UA
MUN	[MUN]	M U N
MUOON	[MUOON]	M UOO N
MUOONG	[MUOONG]	M UOO NG
MUOOSI	[MUOOSI]	M UOOSI
MUOOSN	[MUOOSN]	M UOOS N
MUOOSNG	[MUOOSNG]	M UOOS NG
MUOOST	[MUOOST]	M UOOS T
MUOOFI	[MUOOFI]	M UOOFI
MUOOXI	[MUOOXI]	M UOOXI
MUOOXM	[MUOOXM]	M UOOX M
MUOOXNG	[MUOOXNG]	M UOOX NG
MUOOJN	[MUOOJN]	M UOOJ N
MY	[MY]	M Y
MAF	[MAF]	M AF
MAFI	[MAFI]	M AFI
MAFN	[MAFN]	M AF N
MAFNG	[MAFNG]	M AF NG
MAFNH	[MAFNH]	M AF NH
MAFO	[MAFO]	M AFO
MAFU	[MAFU]	M AFU
MAFY	[MAFY]	M AFY
MAS	[MAS]	M AS
MASC	[MASC]	M AS C
MASCH	[MASCH]	M AS CH
MASI	[MASI]	M ASI
MASN	[MASN]	M AS N
MASNG	[MASNG]	M AS NG
MASNH	[MASNH]	M AS NH
MASO	[MASO]	M ASO
MAST	[MAST]	M AS T
MASU	[MASU]	M ASU
MASY	[MASY]	M ASY
MAAM	[MAAM]	M AA M
MAAN	[MAAN]	M AA N
MAAU	[MAAU]	M AAU
MAAY	[MAAY]	M AAY
MAX	[MAX]	M AX
MAXI	[MAXI]	M AXI
MAXN	[MAXN]	M AX N
MAXNG	[MAXNG]	M AX NG
MAXNH	[MAXNH]	M AX NH
MEF	[MEF]	M EF
MEFN	[MEFN]	M EF N
MEFO	[MEFO]	M EFO
MES	[MES]	M ES
MESM	[MESM]	M ES M
MESN	[MESN]	M ES N
MESO	[MESO]	M ESO
MESP	[MESP]	M ES P
MEST	[MEST]	M ES T
MEE	[MEE]	M EE
MEENH	[MEENH]	M EE NH
MIF	[MIF]	M IF
MIFN	[MIFN]	M IF N
MIFNH	[MIFNH]	M IF NH
MIS	[MIS]	M IS
MISA	[MISA]	M ISA
MISP	[MISP]	M IS P
MIST	[MIST]	M IS T
MISU	[MISU]	M ISU
MOF	[MOF]	M OF
MOFI	[MOFI]	M OFI
MOFN	[MOFN]	M OF N
MOFNG	[MOFNG]	M OF NG
MOS	[MOS]	M OS
MOSC	[MOSC]	M OS C
MOSI	[MOSI]	M OSI
MOSM	[MOSM]	M OS M
MOSN	[MOSN]	M OS N
MOSNG	[MOSNG]	M OS NG
MOSP	[MOSP]	M OS P
MOST	[MOST]	M OS T
MOO	[MOO]	M OO
MOOI	[MOOI]	M OOI
MOON	[MOON]	M OO N
MOONG	[MOONG]	M OO NG
MOX	[MOX]	M OX
MOXM	[MOXM]	M OX M
MUF	[MUF]	M UF
MUFA	[MUFA]	M UFA
MUFI	[MUFI]	M UFI
MUFN	[MUFN]	M UF N
MUFNG	[MUFNG]	M UF NG
MUS	[MUS]	M US
MUSA	[MUSA]	M USA
MUSI	[MUSI]	M USI
MUSN	[MUSN]	M US N
MUSP	[MUSP]	M US P
MUST	[MUST]	M US T
MAWM	[MAWM]	M AW M
MAWN	[MAWN]	M AW N
MAWNG	[MAWNG]	M AW NG
MIXM	[MIXM]	M IX M
MUX	[MUX]	M UX
MUXI	[MUXI]	M UXI
MUXM	[MUXM]	M UX M
MOW	[MOW]	M OW
MOWN	[MOWN]	M OW N
MUWA	[MUWA]	M UWA
MUWU	[MUWU]	M UWU
MUWOWI	[MUWOWI]	M UWOWI
MUWOWNG	[MUWOWNG]	M UWOW NG
MUWOWSN	[MUWOWSN]	M UWOWS N
MUWOWSP	[MUWOWSP]	M UWOWS P
MUWOWST	[MUWOWST]	M UWOWS T
MUWOWFI	[MUWOWFI]	M UWOWFI
MUWOWFNG	[MUWOWFNG]	M UWOWF NG
MUWOWJN	[MUWOWJN]	M UWOWJ N
MUWOWJT	[MUWOWJT]	M UWOWJ T
MAJ	[MAJ]	M AJ
MAJC	[MAJC]	M AJ C
MAJCH	[MAJCH]	M AJ CH
MAJI	[MAJI]	M AJI
MAJN	[MAJN]	M AJ N
MAJNG	[MAJNG]	M AJ NG
MAJNH	[MAJNH]	M AJ NH
MAJO	[MAJO]	M AJO
MAJP	[MAJP]	M AJ P
MAJT	[MAJT]	M AJ T
MAJY	[MAJY]	M AJY
MAR	[MAR]	M AR
MARI	[MARI]	M ARI
MARNG	[MARNG]	M AR NG
MARNH	[MARNH]	M AR NH
MAASN	[MAASN]	M AAS N
MAAST	[MAAST]	M AAS T
MAASU	[MAASU]	M AASU
MAASY	[MAASY]	M AASY
MAAFM	[MAAFM]	M AAF M
MAAFN	[MAAFN]	M AAF N
MAAFU	[MAAFU]	M AAFU
MAARN	[MAARN]	M AAR N
MAARU	[MAARU]	M AARU
MAARY	[MAARY]	M AARY
MAAXN	[MAAXN]	M AAX N
MAAXU	[MAAXU]	M AAXU
MAAJN	[MAAJN]	M AAJ N
MAAJP	[MAAJP]	M AAJ P
MAAJT	[MAAJT]	M AAJ T
MAAJU	[MAAJU]	M AAJU
MAWSC	[MAWSC]	M AWS C
MAWSM	[MAWSM]	M AWS M
MAWSN	[MAWSN]	M AWS N
MAWSNG	[MAWSNG]	M AWS NG
MAWST	[MAWST]	M AWS T
MAWFN	[MAWFN]	M AWF N
MAWRN	[MAWRN]	M AWR N
MAWJC	[MAWJC]	M AWJ C
MAWJN	[MAWJN]	M AWJ N
MAWJT	[MAWJT]	M AWJ T
MEJ	[MEJ]	M EJ
MEJO	[MEJO]	M EJO
MEJT	[MEJT]	M EJ T
MER	[MER]	M ER
MEX	[MEX]	M EX
MEESCH	[MEESCH]	M EES CH
MEESN	[MEESN]	M EES N
MEESU	[MEESU]	M EESU
MEEF	[MEEF]	M EEF
MEEFM	[MEEFM]	M EEF M
MEEFN	[MEEFN]	M EEF N
MEEJ	[MEEJ]	M EEJ
MEEJNH	[MEEJNH]	M EEJ NH
MEEJT	[MEEJT]	M EEJ T
MIR	[MIR]	M IR
MIRA	[MIRA]	M IRA
MIRM	[MIRM]	M IR M
MIJ	[MIJ]	M IJ
MIJN	[MIJN]	M IJ N
MIJT	[MIJT]	M IJ T
MOJ	[MOJ]	M OJ
MOJC	[MOJC]	M OJ C
MOJI	[MOJI]	M OJI
MOJN	[MOJN]	M OJ N
MOJNG	[MOJNG]	M OJ NG
MOJT	[MOJT]	M OJ T
MOR	[MOR]	M OR
MORI	[MORI]	M ORI
MORM	[MORM]	M OR M
MORNG	[MORNG]	M OR NG
MOOSC	[MOOSC]	M OOS C
MOOSI	[MOOSI]	M OOSI
MOOST	[MOOST]	M OOS T
MOOF	[MOOF]	M OOF
MOOFI	[MOOFI]	M OOFI
MOOFM	[MOOFM]	M OOF M
MOOFNG	[MOOFNG]	M OOF NG
MOOR	[MOOR]	M OOR
MOOX	[MOOX]	M OOX
MOOXI	[MOOXI]	M OOXI
MOOJ	[MOOJ]	M OOJ
MOOJC	[MOOJC]	M OOJ C
MOOJNG	[MOOJNG]	M OOJ NG
MOOJT	[MOOJT]	M OOJ T
MOWS	[MOWS]	M OWS
MOWSI	[MOWSI]	M OWSI
MOWSP	[MOWSP]	M OWS P
MOWF	[MOWF]	M OWF
MOWFI	[MOWFI]	M OWFI
MOWR	[MOWR]	M OWR
MOWRN	[MOWRN]	M OWR N
MOWX	[MOWX]	M OWX
MOWJ	[MOWJ]	M OWJ
MUJ	[MUJ]	M UJ
MUJC	[MUJC]	M UJ C
MUJN	[MUJN]	M UJ N
MUJP	[MUJP]	M UJ P
MUR	[MUR]	M UR
MURI	[MURI]	M URI
MURN	[MURN]	M UR N
MUWSC	[MUWSC]	M UWS C
MUWST	[MUWST]	M UWS T
MUWFNG	[MUWFNG]	M UWF NG
MUWRA	[MUWRA]	M UWRA
MUWJC	[MUWJC]	M UWJ C
MYX	[MYX]	M YX
NA	[NA]	N A
NAI	[NAI]	N AI
NAM	[NAM]	N A M
NAN	[NAN]	N A N
NANG	[NANG]	N A NG
NANH	[NANH]	N A NH
NAO	[NAO]	N AO
NAY	[NAY]	N AY
NEM	[NEM]	N E M
NEO	[NEO]	N EO
NGA	[NGA]	NG A
NGAI	[NGAI]	NG AI
NGAN	[NGAN]	NG A N
NGANG	[NGANG]	NG A NG
NGAO	[NGAO]	NG AO
NGAY	[NGAY]	NG AY
NGHE	[NGHE]	NGH E
NGHI	[NGHI]	NGH I
NGHIEEM	[NGHIEEM]	NGH IEE M
NGHIEEN	[NGHIEEN]	NGH IEE N
NGHIEENG	[NGHIEENG]	NGH IEE NG
NGHIEESN	[NGHIEESN]	NGH IEES N
NGHIEEFN	[NGHIEEFN]	NGH IEEF N
NGHIEEJM	[NGHIEEJM]	NGH IEEJ M
NGHIEEJN	[NGHIEEJN]	NGH IEEJ N
NGHIEEJP	[NGHIEEJP]	NGH IEEJ P
NGHIEEJT	[NGHIEEJT]	NGH IEEJ T
NGHEF	[NGHEF]	NGH EF
NGHEFO	[NGHEFO]	NGH EFO
NGHES	[NGHES]	NGH ES
NGHEE	[NGHEE]	NGH EE
NGHEENH	[NGHEENH]	NGH EE NH
NGHEEU	[NGHEEU]	NGH EEU
NGHIFN	[NGHIFN]	NGH IF N
NGHIX	[NGHIX]	NGH IX
NGHIXA	[NGHIXA]	NGH IXA
NGHIXNH	[NGHIXNH]	NGH IX NH
NGHEJN	[NGHEJN]	NGH EJ N
NGHEJO	[NGHEJO]	NGH EJO
NGHEJT	[NGHEJT]	NGH EJ T
NGHERO	[NGHERO]	NGH ERO
NGHEXN	[NGHEXN]	NGH EX N
NGHEESCH	[NGHEESCH]	NGH EES CH
NGHEEF	[NGHEEF]	NGH EEF
NGHEEJ	[NGHEEJ]	NGH EEJ
NGHIR	[NGHIR]	NGH IR
NGHIRU	[NGHIRU]	NGH IRU
NGHIJ	[NGHIJ]	NGH IJ
NGHIJCH	[NGHIJCH]	NGH IJ CH
NGOA	[NGOA]	NG OA
NGOAN	[NGOAN]	NG OA N
NGOANG	[NGOANG]	NG OA NG
NGOAY	[NGOAY]	NG OAY
NGOE	[NGOE]	NG OE
NGOI	[NGOI]	NG OI
NGON	[NGON]	NG O N
NGOAFI	[NGOAFI]	NG OAFI
NGOAFM	[NGOAFM]	NG OAF M
NGOASC	[NGOASC]	NG OAS C
NGOASCH	[NGOASCH]	NG OAS CH
NGOASI	[NGOASI]	NG OASI
NGOASO	[NGOASO]	NG OASO
NGOASY	[NGOASY]	NG OASY
NGOAXN	[NGOAXN]	NG OAX N
NGOEFO	[NGOEFO]	NG OEFO
NGOESO	[NGOESO]	NG OESO
NGOAJI	[NGOAJI]	NG OAJI
NGOAJN	[NGOAJN]	NG OAJ N
NGOARNH	[NGOARNH]	NG OAR NH
NGOAWSC	[NGOAWSC]	NG OAWS C
NGOAWST	[NGOAWST]	NG OAWS T
NGOAWFN	[NGOAWFN]	NG OAWF N
NGOAWFNG	[NGOAWFNG]	NG OAWF NG
NGOAWXNG	[NGOAWXNG]	NG OAWX NG
NGOAWJC	[NGOAWJC]	NG OAWJ C
NGOAWJT	[NGOAWJT]	NG OAWJ T
NGU	[NGU]	NG U
NGUY	[NGUY]	NG UY
NGUYEEN	[NGUYEEN]	NG UYEE N
NGUYEEFN	[NGUYEEFN]	NG UYEEF N
NGUYEEXN	[NGUYEEXN]	NG UYEEX N
NGUYEEJN	[NGUYEEJN]	NG UYEEJ N
NGUYEEJT	[NGUYEEJT]	NG UYEEJ T
NGUAARY	[NGUAARY]	NG UAARY
NGUOOFI	[NGUOOFI]	NG UOOFI
NGUOOFN	[NGUOOFN]	NG UOOF N
NGUOOJI	[NGUOOJI]	NG UOOJI
NGAF	[NGAF]	NG AF
NGAFI	[NGAFI]	NG AFI
NGAFM	[NGAFM]	NG AF M
NGAFN	[NGAFN]	NG AF N
NGAFNG	[NGAFNG]	NG AF NG
NGAFNH	[NGAFNH]	NG AF NH
NGAFO	[NGAFO]	NG AFO
NGAFY	[NGAFY]	NG AFY
NGASCH	[NGASCH]	NG AS CH
NGASN	[NGASN]	NG AS N
NGASNG	[NGASNG]	NG AS NG
NGASO	[NGASO]	NG ASO
NGASP	[NGASP]	NG AS P
NGAST	[NGAST]	NG AS T
NGASU	[NGASU]	NG ASU
NGASY	[NGASY]	NG ASY
NGAAM	[NGAAM]	NG AA M
NGAAN	[NGAAN]	NG AA N
NGAAY	[NGAAY]	NG AAY
NGAX	[NGAX]	NG AX
NGAXI	[NGAXI]	NG AXI
NGISA	[NGISA]	NG ISA
NGOF	[NGOF]	NG OF
NGOFI	[NGOFI]	NG OFI
NGOS	[NGOS]	NG OS
NGOSC	[NGOSC]	NG OS C
NGOSE	[NGOSE]	NG OSE
NGOSI	[NGOSI]	NG OSI
NGOSN	[NGOSN]	NG OS N
NGOSNG	[NGOSNG]	NG OS NG
NGOST	[NGOST]	NG OS T
NGOO	[NGOO]	NG OO
NGOOI	[NGOOI]	NG OOI
NGOON	[NGOON]	NG OO N
NGOONG	[NGOONG]	NG OO NG
NGOX	[NGOX]	NG OX
NGUFI	[NGUFI]	NG UFI
NGUSC	[NGUSC]	NG US C
NGUSNG	[NGUSNG]	NG US NG
NGUST	[NGUST]	NG US T
NGAWN	[NGAWN]	NG AW N
NGUX	[NGUX]	NG UX
NGOW	[NGOW]	NG OW
NGOWI	[NGOWI]	NG OWI
NGUW	[NGUW]	NG UW
NGUWA	[NGUWA]	NG UWA
NGUWNG	[NGUWNG]	NG UW NG
NGUWU	[NGUWU]	NG UWU
NGUWOWI	[NGUWOWI]	NG UWOWI
NGUWOWSC	[NGUWOWSC]	NG UWOWS C
NGUWOWFI	[NGUWOWFI]	NG UWOWFI
NGUWOWRNG	[NGUWOWRNG]	NG UWOWR NG
NGUWOWXNG	[NGUWOWXNG]	NG UWOWX NG
NGUWOWJC	[NGUWOWJC]	NG UWOWJ C
NGUWOWJNG	[NGUWOWJNG]	NG UWOWJ NG
NGAJC	[NGAJC]	NG AJ C
NGAJI	[NGAJI]	NG AJI
NGAJN	[NGAJN]	NG AJ N
NGAJO	[NGAJO]	NG AJO
NGAJT	[NGAJT]	NG AJ T
NGAR	[NGAR]	NG AR
NGARI	[NGARI]	NG ARI
NGARNH	[NGARNH]	NG AR NH
NGAAST	[NGAAST]	NG AAS T
NGAASU	[NGAASU]	NG AASU
NGAASY	[NGAASY]	NG AASY
NGAAFM	[NGAAFM]	NG AAF M
NGAAFN	[NGAAFN]	NG AAF N
NGAAFY	[NGAAFY]	NG AAFY
NGAARM	[NGAARM]	NG AAR M
NGAARN	[NGAARN]	NG AAR N
NGAARNG	[NGAARNG]	NG AAR NG
NGAAXM	[NGAAXM]	NG AAX M
NGAAXU	[NGAAXU]	NG AAXU
NGAAJM	[NGAAJM]	NG AAJ M
NGAAJP	[NGAAJP]	NG AAJ P
NGAAJU	[NGAAJU]	NG AAJU
NGAAJY	[NGAAJY]	NG AAJY
NGAWSC	[NGAWSC]	NG AWS C
NGAWSM	[NGAWSM]	NG AWS M
NGAWSN	[NGAWSN]	NG AWS N
NGAWST	[NGAWST]	NG AWS T
NGAWXNG	[NGAWXNG]	NG AWX NG
NGAWJT	[NGAWJT]	NG AWJ T
NGOJ	[NGOJ]	NG OJ
NGOJC	[NGOJC]	NG OJ C
NGOJN	[NGOJN]	NG OJ N
NGOJNG	[NGOJNG]	NG OJ NG
NGOJT	[NGOJT]	NG OJ T
NGOR	[NGOR]	NG OR
NGOOSC	[NGOOSC]	NG OOS C
NGOOFI	[NGOOFI]	NG OOFI
NGOOFM	[NGOOFM]	NG OOF M
NGOOFN	[NGOOFN]	NG OOF N
NGOOR	[NGOOR]	NG OOR
NGOORM	[NGOORM]	NG OOR M
NGOOX	[NGOOX]	NG OOX
NGOOJ	[NGOOJ]	NG OOJ
NGOOJN	[NGOOJN]	NG OOJ N
NGOOJT	[NGOOJT]	NG OOJ T
NGOWSN	[NGOWSN]	NG OWS N
NGOWST	[NGOWST]	NG OWS T
NGOWF	[NGOWF]	NG OWF
NGOWX	[NGOWX]	NG OWX
NGOWJ	[NGOWJ]	NG OWJ
NGOWJI	[NGOWJI]	NG OWJI
NGOWJM	[NGOWJM]	NG OWJ M
NGOWJP	[NGOWJP]	NG OWJ P
NGUJ	[NGUJ]	NG UJ
NGUJA	[NGUJA]	NG UJA
NGUJC	[NGUJC]	NG UJ C
NGUJM	[NGUJM]	NG UJ M
NGUJP	[NGUJP]	NG UJ P
NGUR	[NGUR]	NG UR
NGURI	[NGURI]	NG URI
NGURN	[NGURN]	NG UR N
NGUWS	[NGUWS]	NG UWS
NGUWSA	[NGUWSA]	NG UWSA
NGUWFA	[NGUWFA]	NG UWFA
NGUWFNG	[NGUWFNG]	NG UWF NG
NGUWRI	[NGUWRI]	NG UWRI
NGUWRNG	[NGUWRNG]	NG UWR NG
NGUWX	[NGUWX]	NG UWX
NGUWJ	[NGUWJ]	NG UWJ
NGUWJA	[NGUWJA]	NG UWJA
NGUWJC	[NGUWJC]	NG UWJ C
NHA	[NHA]	NH A
NHAI	[NHAI]	NH AI
NHAM	[NHAM]	NH A M
NHAN	[NHAN]	NH A N
NHANG	[NHANG]	NH A NG
NHANH	[NHANH]	NH A NH
NHAO	[NHAO]	NH AO
NHAU	[NHAU]	NH AU
NHAY	[NHAY]	NH AY
NHE	[NHE]	NH E
NHEM	[NHEM]	NH E M
NHEN	[NHEN]	NH E N
NHEO	[NHEO]	NH EO
NHI	[NHI]	NH I
NHIEEN	[NHIEEN]	NH IEE N
NHIEEU	[NHIEEU]	NH IEEU
NHIEESC	[NHIEESC]	NH IEES C
NHIEESP	[NHIEESP]	NH IEES P
NHIEEFU	[NHIEEFU]	NH IEEFU
NHIEEXM	[NHIEEXM]	NH IEEX M
NHIEEXU	[NHIEEXU]	NH IEEXU
NHIEEJM	[NHIEEJM]	NH IEEJ M
NHIEEJT	[NHIEEJT]	NH IEEJ T
NHO	[NHO]	NH O
NHOAI	[NHOAI]	NH OAI
NHOE	[NHOE]	NH OE
NHOEN	[NHOEN]	NH OE N
NHOM	[NHOM]	NH O M
NHONG	[NHONG]	NH O NG
NHOAFI	[NHOAFI]	NH OAFI
NHOASNG	[NHOASNG]	NH OAS NG
NHOEST	[NHOEST]	NH OES T
NHOERN	[NHOERN]	NH OER N
NHU	[NHU]	NH U
NHUNG	[NHUNG]	NH U NG
NHUYEEXN	[NHUYEEXN]	NH UYEEX N
NHUAAFN	[NHUAAFN]	NH UAAF N
NHUAAJN	[NHUAAJN]	NH UAAJ N
NHUEEJ	[NHUEEJ]	NH UEEJ
NHUOOSM	[NHUOOSM]	NH UOOS M
NHUOOJM	[NHUOOJM]	NH UOOJ M
NHAF	[NHAF]	NH AF
NHAFI	[NHAFI]	NH AFI
NHAFM	[NHAFM]	NH AF M
NHAFN	[NHAFN]	NH AF N
NHAFNG	[NHAFNG]	NH AF NG
NHAFNH	[NHAFNH]	NH AF NH
NHAFO	[NHAFO]	NH AFO
NHAFU	[NHAFU]	NH AFU
NHAS	[NHAS]	NH AS
NHASC	[NHASC]	NH AS C
NHASNG	[NHASNG]	NH AS NG
NHASNH	[NHASNH]	NH AS NH
NHASO	[NHASO]	NH ASO
NHAST	[NHAST]	NH AS T
NHASY	[NHASY]	NH ASY
NHAAM	[NHAAM]	NH AA M
NHAAN	[NHAAN]	NH AA N
NHAX	[NHAX]	NH AX
NHAXI	[NHAXI]	NH AXI
NHAXN	[NHAXN]	NH AX N
NHAXO	[NHAXO]	NH AXO
NHEF	[NHEF]	NH EF
NHEFM	[NHEFM]	NH EF M
NHES	[NHES]	NH ES
NHESP	[NHESP]	NH ES P
NHEST	[NHEST]	NH ES T
NHIF	[NHIF]	NH IF
NHIFN	[NHIFN]	NH IF N
NHIS	[NHIS]	NH IS
NHISCH	[NHISCH]	NH IS CH
NHISM	[NHISM]	NH IS M
NHIST	[NHIST]	NH IS T
NHISU	[NHISU]	NH ISU
NHOFE	[NHOFE]	NH OFE
NHOFM	[NHOFM]	NH OF M
NHOSC	[NHOSC]	NH OS C
NHOSI	[NHOSI]	NH OSI
NHOSM	[NHOSM]	NH OS M
NHOSNG	[NHOSNG]	NH OS NG
NHOSP	[NHOSP]	NH OS P
NHOST	[NHOST]	NH OS T
NHOO	[NHOO]	NH OO
NHOOM	[NHOOM]	NH OO M
NHOON	[NHOON]	NH OO N
NHOONG	[NHOONG]	NH OO NG
NHOX	[NHOX]	NH OX
NHOXM	[NHOXM]	NH OX M
NHOXN	[NHOXN]	NH OX N
NHOXNG	[NHOXNG]	NH OX NG
NHUF	[NHUF]	NH UF
NHUFI	[NHUFI]	NH UFI
NHUFNG	[NHUFNG]	NH UF NG
NHUS	[NHUS]	NH US
NHUSA	[NHUSA]	NH USA
NHUSC	[NHUSC]	NH US C
NHUSN	[NHUSN]	NH US N
NHUSNG	[NHUSNG]	NH US NG
NHUST	[NHUST]	NH US T
NHAWM	[NHAWM]	NH AW M
NHAWN	[NHAWN]	NH AW N
NHAWNG	[NHAWNG]	NH AW NG
NHIX	[NHIX]	NH IX
NHUX	[NHUX]	NH UX
NHUXNG	[NHUXNG]	NH UX NG
NHOWI	[NHOWI]	NH OWI
NHOWN	[NHOWN]	NH OW N
NHUW	[NHUW]	NH UW
NHUWNG	[NHUWNG]	NH UW NG
NHUWOWSNG	[NHUWOWSNG]	NH UWOWS NG
NHUWOWFNG	[NHUWOWFNG]	NH UWOWF NG
NHUWOWXNG	[NHUWOWXNG]	NH UWOWX NG
NHUWOWJC	[NHUWOWJC]	NH UWOWJ C
NHUWOWJNG	[NHUWOWJNG]	NH UWOWJ NG
NHAJC	[NHAJC]	NH AJ C
NHAJI	[NHAJI]	NH AJI
NHAJNH	[NHAJNH]	NH AJ NH
NHAJO	[NHAJO]	NH AJO
NHAJT	[NHAJT]	NH AJ T
NHAJY	[NHAJY]	NH AJY
NHAR	[NHAR]	NH AR
NHARI	[NHARI]	NH ARI
NHARM	[NHARM]	NH AR M
NHARNH	[NHARNH]	NH AR NH
NHARY	[NHARY]	NH ARY
NHAASC	[NHAASC]	NH AAS C
NHAASM	[NHAASM]	NH AAS M
NHAASN	[NHAASN]	NH AAS N
NHAASP	[NHAASP]	NH AAS P
NHAAST	[NHAAST]	NH AAS T
NHAAFM	[NHAAFM]	NH AAF M
NHAAFY	[NHAAFY]	NH AAFY
NHAARM	[NHAARM]	NH AAR M
NHAAXN	[NHAAXN]	NH AAX N
NHAAXY	[NHAAXY]	NH AAXY
NHAAJM	[NHAAJM]	NH AAJ M
NHAAJN	[NHAAJN]	NH AAJ N
NHAAJP	[NHAAJP]	NH AAJ P
NHAAJT	[NHAAJT]	NH AAJ T
NHAAJU	[NHAAJU]	NH AAJU
NHAWSC	[NHAWSC]	NH AWS C
NHAWSM	[NHAWSM]	NH AWS M
NHAWSN	[NHAWSN]	NH AWS N
NHAWST	[NHAWST]	NH AWS T
NHAWFM	[NHAWFM]	NH AWF M
NHAWFN	[NHAWFN]	NH AWF N
NHAWFNG	[NHAWFNG]	NH AWF NG
NHAWXN	[NHAWXN]	NH AWX N
NHAWJM	[NHAWJM]	NH AWJ M
NHAWJNG	[NHAWJNG]	NH AWJ NG
NHAWJT	[NHAWJT]	NH AWJ T
NHEJ	[NHEJ]	NH EJ
NHEJM	[NHEJM]	NH EJ M
NHEJP	[NHEJP]	NH EJ P
NHERM	[NHERM]	NH ER M
NHEXO	[NHEXO]	NH EXO
NHEESCH	[NHEESCH]	NH EES CH
NHEEJN	[NHEEJN]	NH EEJ N
NHEEJU	[NHEEJU]	NH EEJU
NHIR	[NHIR]	NH IR
NHIRNH	[NHIRNH]	NH IR NH
NHIJ	[NHIJ]	NH IJ
NHIJN	[NHIJN]	NH IJ N
NHIJP	[NHIJP]	NH IJ P
NHOJC	[NHOJC]	NH OJ C
NHOJN	[NHOJN]	NH OJ N
NHOJT	[NHOJT]	NH OJ T
NHOR	[NHOR]	NH OR
NHORM	[NHORM]	NH OR M
NHOOS	[NHOOS]	NH OOS
NHOOSI	[NHOOSI]	NH OOSI
NHOOST	[NHOOST]	NH OOS T
NHOOFI	[NHOOFI]	NH OOFI
NHOOFN	[NHOOFN]	NH OOF N
NHOORM	[NHOORM]	NH OOR M
NHOORN	[NHOORN]	NH OOR N
NHOOJN	[NHOOJN]	NH OOJ N
NHOOJT	[NHOOJT]	NH OOJ T
NHOWS	[NHOWS]	NH OWS
NHOWSP	[NHOWSP]	NH OWS P
NHOWF	[NHOWF]	NH OWF
NHOWFN	[NHOWFN]	NH OWF N
NHOWR	[NHOWR]	NH OWR
NHOWJT	[NHOWJT]	NH OWJ T
NHUJA	[NHUJA]	NH UJA
NHUJC	[NHUJC]	NH UJ C
NHUJY	[NHUJY]	NH UJY
NHUR	[NHUR]	NH UR
NHURN	[NHURN]	NH UR N
NHUWS	[NHUWS]	NH UWS
NHUWSC	[NHUWSC]	NH UWS C
NHUWXNG	[NHUWXNG]	NH UWX NG
NHUWJA	[NHUWJA]	NH UWJA
NHUWJT	[NHUWJT]	NH UWJ T
NI	[NI]	N I
NIA	[NIA]	N IA
NIN	[NIN]	N I N
NINH	[NINH]	N I NH
NIU	[NIU]	N IU
NIEEM	[NIEEM]	N IEE M
NIEEN	[NIEEN]	N IEE N
NIEEU	[NIEEU]	N IEEU
NIEEST	[NIEEST]	N IEES T
NIEEFM	[NIEEFM]	N IEEF M
NIEEFNG	[NIEEFNG]	N IEEF NG
NIEEJM	[NIEEJM]	N IEEJ M
NIEEJU	[NIEEJU]	N IEEJU
NO	[NO]	N O
NOM	[NOM]	N O M
NON	[NON]	N O N
NONG	[NONG]	N O NG
NUA	[NUA]	N UA
NUNG	[NUNG]	N U NG
NUOOI	[NUOOI]	N UOOI
NUOONG	[NUOONG]	N UOO NG
NUOOSI	[NUOOSI]	N UOOSI
NUOOST	[NUOOST]	N UOOS T
NAF	[NAF]	N AF
NAFN	[NAFN]	N AF N
NAFNG	[NAFNG]	N AF NG
NAFNH	[NAFNH]	N AF NH
NAFO	[NAFO]	N AFO
NAFY	[NAFY]	N AFY
NAS	[NAS]	N AS
NASCH	[NASCH]	N AS CH
NASM	[NASM]	N AS M
NASN	[NASN]	N AS N
NASO	[NASO]	N ASO
NAST	[NAST]	N AS T
NASU	[NASU]	N ASU
NASY	[NASY]	N ASY
NAANG	[NAANG]	N AA NG
NAAU	[NAAU]	N AAU
NAAY	[NAAY]	N AAY
NAXO	[NAXO]	N AXO
NAXY	[NAXY]	N AXY
NEF	[NEF]	N EF
NEFO	[NEFO]	N EFO
NES	[NES]	N ES
NESM	[NESM]	N ES M
NESN	[NESN]	N ES N
NESO	[NESO]	N ESO
NESP	[NESP]	N ES P
NEST	[NEST]	N ES T
NEE	[NEE]	N EE
NEEM	[NEEM]	N EE M
NEEN	[NEEN]	N EE N
NEEU	[NEEU]	N EEU
NIF	[NIF]	N IF
NIFNH	[NIFNH]	N IF NH
NISCH	[NISCH]	N IS CH
NISN	[NISN]	N IS N
NISNH	[NISNH]	N IS NH
NIST	[NIST]	N IS T
NISU	[NISU]	N ISU
NOS	[NOS]	N OS
NOSC	[NOSC]	N OS C
NOSI	[NOSI]	N OSI
NOSN	[NOSN]	N OS N
NOSNG	[NOSNG]	N OS NG
NOST	[NOST]	N OS T
NOO	[NOO]	N OO
NOOI	[NOOI]	N OOI
NOOM	[NOOM]	N OO M
NOON	[NOON]	N OO N
NOONG	[NOONG]	N OO NG
NOXN	[NOXN]	N OX N
NUFN	[NUFN]	N UF N
NUFNG	[NUFNG]	N UF NG
NUSC	[NUSC]	N US C
NUSI	[NUSI]	N USI
NUSM	[NUSM]	N US M
NUSNG	[NUSNG]	N US NG
NUSP	[NUSP]	N US P
NUST	[NUST]	N US T
NAWM	[NAWM]	N AW M
NAWN	[NAWN]	N AW N
NAWNG	[NAWNG]	N AW NG
NIXA	[NIXA]	N IXA
NUXNG	[NUXNG]	N UX NG
NOWI	[NOWI]	N OWI
NOWM	[NOWM]	N OW M
NUW	[NUW]	N UW
NUWOWNG	[NUWOWNG]	N UWOW NG
NUWOWSC	[NUWOWSC]	N UWOWS C
NUWOWSNG	[NUWOWSNG]	N UWOWS NG
NAJ	[NAJ]	N AJ
NAJC	[NAJC]	N AJ C
NAJI	[NAJI]	N AJI
NAJN	[NAJN]	N AJ N
NAJNH	[NAJNH]	N AJ NH
NAJO	[NAJO]	N AJO
NAJP	[NAJP]	N AJ P
NAJT	[NAJT]	N AJ T
NAR	[NAR]	N AR
NARN	[NARN]	N AR N
NARY	[NARY]	N ARY
NAASC	[NAASC]	N AAS C
NAASM	[NAASM]	N AAS M
NAASNG	[NAASNG]	N AAS NG
NAASU	[NAASU]	N AASU
NAASY	[NAASY]	N AASY
NAAFN	[NAAFN]	N AAF N
NAAFY	[NAAFY]	N AAFY
NAAJM	[NAAJM]	N AAJ M
NAAJP	[NAAJP]	N AAJ P
NAAJU	[NAAJU]	N AAJU
NAWSC	[NAWSC]	N AWS C
NAWSM	[NAWSM]	N AWS M
NAWSN	[NAWSN]	N AWS N
NAWSNG	[NAWSNG]	N AWS NG
NAWSP	[NAWSP]	N AWS P
NAWFM	[NAWFM]	N AWF M
NAWFN	[NAWFN]	N AWF N
NAWFNG	[NAWFNG]	N AWF NG
NAWXNG	[NAWXNG]	N AWX NG
NAWJC	[NAWJC]	N AWJ C
NAWJNG	[NAWJNG]	N AWJ NG
NEJP	[NEJP]	N EJ P
NER	[NER]	N ER
NERO	[NERO]	N ERO
NEESM	[NEESM]	N EES M
NEESN	[NEESN]	N EES N
NEESP	[NEESP]	N EES P
NEEST	[NEEST]	N EES T
NEESU	[NEESU]	N EESU
NEEF	[NEEF]	N EEF
NEEFN	[NEEFN]	N EEF N
NEER	[NEER]	N EER
NEEJ	[NEEJ]	N EEJ
NEEJM	[NEEJM]	N EEJ M
NIR	[NIR]	N IR
NIJCH	[NIJCH]	N IJ CH
NIJNH	[NIJNH]	N IJ NH
NIJU	[NIJU]	N IJU
NOJ	[NOJ]	N OJ
NOJC	[NOJC]	N OJ C
NOJNG	[NOJNG]	N OJ NG
NOJT	[NOJT]	N OJ T
NOR	[NOR]	N OR
NOOS	[NOOS]	N OOS
NOOSC	[NOOSC]	N OOS C
NOOSI	[NOOSI]	N OOSI
NOOSNG	[NOOSNG]	N OOS NG
NOOST	[NOOST]	N OOS T
NOOF	[NOOF]	N OOF
NOOFI	[NOOFI]	N OOFI
NOOFM	[NOOFM]	N OOF M
NOOFNG	[NOOFNG]	N OOF NG
NOOR	[NOOR]	N OOR
NOORI	[NOORI]	N OORI
NOOX	[NOOX]	N OOX
NOOXI	[NOOXI]	N OOXI
NOOJ	[NOOJ]	N OOJ
NOOJC	[NOOJC]	N OOJ C
NOOJI	[NOOJI]	N OOJI
NOOJN	[NOOJN]	N OOJ N
NOOJP	[NOOJP]	N OOJ P
NOWS	[NOWS]	N OWS
NOWSI	[NOWSI]	N OWSI
NOWSP	[NOWSP]	N OWS P
NOWST	[NOWST]	N OWS T
NOWR	[NOWR]	N OWR
NOWX	[NOWX]	N OWX
NOWJ	[NOWJ]	N OWJ
NUJ	[NUJ]	N UJ
NUWSC	[NUWSC]	N UWS C
NUWST	[NUWST]	N UWS T
NUWRA	[NUWRA]	N UWRA
NUWX	[NUWX]	N UWX
NUWXA	[NUWXA]	N UWXA
NUWJ	[NUWJ]	N UWJ
NUWJC	[NUWJC]	N UWJ C
O	[O]	O
OAI	[OAI]	OAI
OAN	[OAN]	OA N
OANH	[OANH]	OA NH
OE	[OE]	OE
OI	[OI]	OI
OM	[OM]	O M
ONG	[ONG]	O NG
OAFNH	[OAFNH]	OAF NH
OASCH	[OASCH]	OAS CH
OASI	[OASI]	OASI
OASN	[OASN]	OAS N
OAWM	[OAWM]	OAW M
OAJP	[OAJP]	OAJ P
OARI	[OARI]	OARI
OAWST	[OAWST]	OAWS T
OAWFN	[OAWFN]	OAWF N
PA	[PA]	P A
PHA	[PHA]	PH A
PHAN	[PHAN]	PH A N
PHANH	[PHANH]	PH A NH
PHAO	[PHAO]	PH AO
PHE	[PHE]	PH E
PHI	[PHI]	PH I
PHIM	[PHIM]	PH I M
PHIEEN	[PHIEEN]	PH IEE N
PHIEEU	[PHIEEU]	PH IEEU
PHIEESM	[PHIEESM]	PH IEES M
PHIEEST	[PHIEEST]	PH IEES T
PHIEESU	[PHIEESU]	PH IEESU
PHIEEFN	[PHIEEFN]	PH IEEF N
PHIEEJN	[PHIEEJN]	PH IEEJ N
PHO	[PHO]	PH O
PHONG	[PHONG]	PH O NG
PHU	[PHU]	PH U
PHUN	[PHUN]	PH U N
PHUNG	[PHUNG]	PH U NG
PHUY	[PHUY]	PH UY
PHAFM	[PHAFM]	PH AF M
PHAFN	[PHAFN]	PH AF N
PHAFO	[PHAFO]	PH AFO
PHAS	[PHAS]	PH AS
PHASC	[PHASC]	PH AS C
PHASCH	[PHASCH]	PH AS CH
PHASI	[PHASI]	PH ASI
PHASN	[PHASN]	PH AS N
PHASO	[PHASO]	PH ASO
PHASP	[PHASP]	PH AS P
PHAST	[PHAST]	PH AS T
PHAAN	[PHAAN]	PH AA N
PHAAY	[PHAAY]	PH AAY
PHEF	[PHEF]	PH EF
PHEFN	[PHEFN]	PH EF N
PHEFO	[PHEFO]	PH EFO
PHESNG	[PHESNG]	PH ES NG
PHESP	[PHESP]	PH ES P
PHEST	[PHEST]	PH ES T
PHEE	[PHEE]	PH EE
PHIF	[PHIF]	PH IF
PHIFNH	[PHIFNH]	PH IF NH
PHIS	[PHIS]	PH IS
PHISA	[PHISA]	PH ISA
PHISCH	[PHISCH]	PH IS CH
PHISM	[PHISM]	PH IS M
PHISNH	[PHISNH]	PH IS NH
PHOF	[PHOF]	PH OF
PHOFI	[PHOFI]	PH OFI
PHOFNG	[PHOFNG]	PH OF NG
PHOS	[PHOS]	PH OS
PHOSC	[PHOSC]	PH OS C
PHOSNG	[PHOSNG]	PH OS NG
PHOST	[PHOST]	PH OS T
PHOO	[PHOO]	PH OO
PHUF	[PHUF]	PH UF
PHUFNG	[PHUFNG]	PH UF NG
PHUS	[PHUS]	PH US
PHUSC	[PHUSC]	PH US C
PHUSNG	[PHUSNG]	PH US NG
PHUST	[PHUST]	PH US T
PHAWNG	[PHAWNG]	PH AW NG
PHIXNH	[PHIXNH]	PH IX NH
PHOW	[PHOW]	PH OW
PHOWI	[PHOWI]	PH OWI
PHOWN	[PHOWN]	PH OW N
PHUWOWNG	[PHUWOWNG]	PH UWOW NG
PHUWOWSC	[PHUWOWSC]	PH UWOWS C
PHUWOWSN	[PHUWOWSN]	PH UWOWS N
PHUWOWFNG	[PHUWOWFNG]	PH UWOWF NG
PHUWOWJNG	[PHUWOWJNG]	PH UWOWJ NG
PHAJC	[PHAJC]	PH AJ C
PHAJM	[PHAJM]	PH AJ M
PHAJNG	[PHAJNG]	PH AJ NG
PHAJT	[PHAJT]	PH AJ T
PHAR	[PHAR]	PH AR
PHARI	[PHARI]	PH ARI
PHARN	[PHARN]	PH AR N
PHARY	[PHARY]	PH ARY
PHAASN	[PHAASN]	PH AAS N
PHAAST	[PHAAST]	PH AAS T
PHAAFM	[PHAAFM]	PH AAF M
PHAAFN	[PHAAFN]	PH AAF N
PHAARM	[PHAARM]	PH AAR M
PHAARY	[PHAARY]	PH AARY
PHAAXN	[PHAAXN]	PH AAX N
PHAAXU	[PHAAXU]	PH AAXU
PHAAJN	[PHAAJN]	PH AAJ N
PHAAJT	[PHAAJT]	PH AAJ T
PHAWSC	[PHAWSC]	PH AWS C
PHAWRNG	[PHAWRNG]	PH AWR NG
PHEES	[PHEES]	PH EES
PHEESCH	[PHEESCH]	PH EES CH
PHEEST	[PHEEST]	PH EES T
PHEEF	[PHEEF]	PH EEF
PHEEFU	[PHEEFU]	PH EEFU
PHEEXU	[PHEEXU]	PH EEXU
PHEEJ	[PHEEJ]	PH EEJ
PHEEJNH	[PHEEJNH]	PH EEJ NH
PHIR	[PHIR]	PH IR
PHIRNH	[PHIRNH]	PH IR NH
PHIJCH	[PHIJCH]	PH IJ CH
PHOJT	[PHOJT]	PH OJ T
PHORNG	[PHORNG]	PH OR NG
PHOOS	[PHOOS]	PH OOS
PHOOSC	[PHOOSC]	PH OOS C
PHOOSI	[PHOOSI]	PH OOSI
PHOOFM	[PHOOFM]	PH OOF M
PHOOFNG	[PHOOFNG]	PH OOF NG
PHOOR	[PHOOR]	PH OOR
PHOORI	[PHOORI]	PH OORI
PHOORNG	[PHOORNG]	PH OOR NG
PHOOXNG	[PHOOXNG]	PH OOX NG
PHOOJNG	[PHOOJNG]	PH OOJ NG
PHOWSI	[PHOWSI]	PH OWSI
PHOWST	[PHOWST]	PH OWS T
PHOWF	[PHOWF]	PH OWF
PHOWR	[PHOWR]	PH OWR
PHOWXN	[PHOWXN]	PH OWX N
PHUJ	[PHUJ]	PH UJ
PHUJC	[PHUJC]	PH UJ C
PHUJNG	[PHUJNG]	PH UJ NG
PHUR	[PHUR]	PH UR
PHURI	[PHURI]	PH URI
PHUWSC	[PHUWSC]	PH UWS C
PIN	[PIN]	P I N
PIEEU	[PIEEU]	P IEEU
PIS	[PIS]	P IS
QUA	[QUA]	QU A
QUAI	[QUAI]	QU AI
QUAN	[QUAN]	QU A N
QUANG	[QUANG]	QU A NG
QUANH	[QUANH]	QU A NH
QUAY	[QUAY]	QU AY
QUE	[QUE]	QU E
QUEN	[QUEN]	QU E N
QUEO	[QUEO]	QU EO
QUI	[QUI]	QU I
QUOAJNG	[QUOAJNG]	QU OAJ NG
QUY	[QUY]	QU Y
QUYEEN	[QUYEEN]	QU YEE N
QUYEESN	[QUYEESN]	QU YEES N
QUYEEST	[QUYEEST]	QU YEES T
QUYEEFN	[QUYEEFN]	QU YEEF N
QUYEERN	[QUYEERN]	QU YEER N
QUYEEJN	[QUYEEJN]	QU YEEJ N
QUYEEJT	[QUYEEJT]	QU YEEJ T
QUAF	[QUAF]	QU AF
QUAFI	[QUAFI]	QU AFI
QUAFNG	[QUAFNG]	QU AF NG
QUAFY	[QUAFY]	QU AFY
QUAS	[QUAS]	QU AS
QUASC	[QUASC]	QU AS C
QUASCH	[QUASCH]	QU AS CH
QUASI	[QUASI]	QU ASI
QUASN	[QUASN]	QU AS N
QUASNG	[QUASNG]	QU AS NG
QUASNH	[QUASNH]	QU AS NH
QUAST	[QUAST]	QU AS T
QUAAN	[QUAAN]	QU AA N
QUAAY	[QUAAY]	QU AAY
QUAXNG	[QUAXNG]	QU AX NG
QUEF	[QUEF]	QU EF
QUEFN	[QUEFN]	QU EF N
QUEST	[QUEST]	QU ES T
QUEE	[QUEE]	QU EE
QUEEN	[QUEEN]	QU EE N
QUIF	[QUIF]	QU IF
QUIS	[QUIS]	QU IS
QUIST	[QUIST]	QU IS T
QUYS	[QUYS]	QU YS
QUYSNH	[QUYSNH]	QU YS NH
QUYST	[QUYST]	QU YS T
QUAWM	[QUAWM]	QU AW M
QUAWNG	[QUAWNG]	QU AW NG
QUIX	[QUIX]	QU IX
QUAJC	[QUAJC]	QU AJ C
QUAJCH	[QUAJCH]	QU AJ CH
QUAJI	[QUAJI]	QU AJI
QUAJNG	[QUAJNG]	QU AJ NG
QUAJNH	[QUAJNH]	QU AJ NH
QUAJT	[QUAJT]	QU AJ T
QUAR	[QUAR]	QU AR
QUARI	[QUARI]	QU ARI
QUARN	[QUARN]	QU AR N
QUARNG	[QUARNG]	QU AR NG
QUARY	[QUARY]	QU ARY
QUAASN	[QUAASN]	QU AAS N
QUAAST	[QUAAST]	QU AAS T
QUAASY	[QUAASY]	QU AASY
QUAAFN	[QUAAFN]	QU AAF N
QUAAFNG	[QUAAFNG]	QU AAF NG
QUAAFY	[QUAAFY]	QU AAFY
QUAARN	[QUAARN]	QU AAR N
QUAAXN	[QUAAXN]	QU AAX N
QUAAXY	[QUAAXY]	QU AAXY
QUAAJN	[QUAAJN]	QU AAJ N
QUAAJT	[QUAAJT]	QU AAJ T
QUAAJY	[QUAAJY]	QU AAJY
QUAWSC	[QUAWSC]	QU AWS C
QUAWSN	[QUAWSN]	QU AWS N
QUAWFN	[QUAWFN]	QU AWF N
QUAWRNG	[QUAWRNG]	QU AWR NG
QUAWJC	[QUAWJC]	QU AWJ C
QUAWJM	[QUAWJM]	QU AWJ M
QUAWJN	[QUAWJN]	QU AWJ N
QUAWJT	[QUAWJT]	QU AWJ T
QUEJO	[QUEJO]	QU EJO
QUEES	[QUEES]	QU EES
QUEEST	[QUEEST]	QU EES T
QUEEFNH	[QUEEFNH]	QU EEF NH
QUEEJ	[QUEEJ]	QU EEJ
QUEEJNH	[QUEEJNH]	QU EEJ NH
QUIR	[QUIR]	QU IR
QUIJ	[QUIJ]	QU IJ
QUOOSC	[QUOOSC]	QU OOS C
QUOWSI	[QUOWSI]	QU OWSI
QUOWF	[QUOWF]	QU OWF
QUOWFN	[QUOWFN]	QU OWF N
QUYF	[QUYF]	QU YF
QUYFNH	[QUYFNH]	QU YF NH
QUYJ	[QUYJ]	QU YJ
QUYJT	[QUYJT]	QU YJ T
QUYR	[QUYR]	QU YR
QUYX	[QUYX]	QU YX
RA	[RA]	R A
RAI	[RAI]	R AI
RAM	[RAM]	R A M
RAN	[RAN]	R A N
RANG	[RANG]	R A NG
RANH	[RANH]	R A NH
RAO	[RAO]	R AO
RAU	[RAU]	R AU
RAY	[RAY]	R AY
RE	[RE]	R E
REN	[REN]	R E N
REO	[REO]	R EO
RI	[RI]	R I
RIA	[RIA]	R IA
RINH	[RINH]	R I NH
RIU	[RIU]	R IU
RIEENG	[RIEENG]	R IEE NG
RIEEU	[RIEEU]	R IEEU
RIEESP	[RIEESP]	R IEES P
RIEEST	[RIEEST]	R IEES T
RIEEJT	[RIEEJT]	R IEEJ T
RO	[RO]	R O
ROI	[ROI]	R OI
ROM	[ROM]	R O M
RONG	[RONG]	R O NG
RU	[RU]	R U
RUA	[RUA]	R UA
RUN	[RUN]	R U N
RUNG	[RUNG]	R U NG
RUOOSC	[RUOOSC]	R UOOS C
RUOOFI	[RUOOFI]	R UOOFI
RUOORI	[RUOORI]	R UOORI
RUOOXNG	[RUOOXNG]	R UOOX NG
RUOOJNG	[RUOOJNG]	R UOOJ NG
RUOOJT	[RUOOJT]	R UOOJ T
RAF	[RAF]	R AF
RAFNG	[RAFNG]	R AF NG
RAFNH	[RAFNH]	R AF NH
RAFO	[RAFO]	R AFO
RAFY	[RAFY]	R AFY
RASC	[RASC]	R AS C
RASCH	[RASCH]	R AS CH
RASI	[RASI]	R ASI
RASN	[RASN]	R AS N
RASNG	[RASNG]	R AS NG
RASO	[RASO]	R ASO
RASP	[RASP]	R AS P
RAST	[RAST]	R AS T
RASY	[RASY]	R ASY
RAAM	[RAAM]	R AA M
RAAN	[RAAN]	R AA N
RAAU	[RAAU]	R AAU
RAX	[RAX]	R AX
RAXI	[RAXI]	R AXI
RAXY	[RAXY]	R AXY
REFM	[REFM]	R EF M
REFN	[REFN]	R EF N
REFO	[REFO]	R EFO
RESN	[RESN]	R ES N
RESO	[RESO]	R ESO
REST	[REST]	R ES T
REE	[REE]	R EE
REEN	[REEN]	R EE N
REEU	[REEU]	R EEU
RIF	[RIF]	R IF
RIFA	[RIFA]	R IFA
RIFNH	[RIFNH]	R IF NH
RIST	[RIST]	R IS T
RISU	[RISU]	R ISU
ROFI	[ROFI]	R OFI
ROFM	[ROFM]	R OF M
ROFNG	[ROFNG]	R OF NG
ROS	[ROS]	R OS
ROSC	[ROSC]	R OS C
ROSI	[ROSI]	R OSI
ROSN	[ROSN]	R OS N
ROST	[ROST]	R OS T
ROO	[ROO]	R OO
ROX	[ROX]	R OX
RUFA	[RUFA]	R UFA
RUFM	[RUFM]	R UF M
RUS	[RUS]	R US
RUSC	[RUSC]	R US C
RUSM	[RUSM]	R US M
RUSNG	[RUSNG]	R US NG
RUST	[RUST]	R US T
RAWN	[RAWN]	R AW N
RAWNG	[RAWNG]	R AW NG
RIX	[RIX]	R IX
RUX	[RUX]	R UX
ROW	[ROW]	R OW
ROWI	[ROWI]	R OWI
ROWM	[ROWM]	R OW M
ROWN	[ROWN]	R OW N
RUWNG	[RUWNG]	R UW NG
RUWOWI	[RUWOWI]	R UWOWI
RUWOWSC	[RUWOWSC]	R UWOWS C
RUWOWSI	[RUWOWSI]	R UWOWSI
RUWOWSM	[RUWOWSM]	R UWOWS M
RUWOWFI	[RUWOWFI]	R UWOWFI
RUWOWRI	[RUWOWRI]	R UWOWRI
RUWOWXI	[RUWOWXI]	R UWOWXI
RUWOWJI	[RUWOWJI]	R UWOWJI
RUWOWJT	[RUWOWJT]	R UWOWJ T
RUWOWJU	[RUWOWJU]	R UWOWJU
RAJ	[RAJ]	R AJ
RAJCH	[RAJCH]	R AJ CH
RAJN	[RAJN]	R AJ N
RAJNG	[RAJNG]	R AJ NG
RAJO	[RAJO]	R AJO
RAJP	[RAJP]	R AJ P
RAJT	[RAJT]	R AJ T
RAR	[RAR]	R AR
RARI	[RARI]	R ARI
RARNH	[RARNH]	R AR NH
RARO	[RARO]	R ARO
RAASN	[RAASN]	R AAS N
RAASP	[RAASP]	R AAS P
RAAST	[RAAST]	R AAS T
RAAFM	[RAAFM]	R AAF M
RAAFN	[RAAFN]	R AAF N
RAAFU	[RAAFU]	R AAFU
RAAFY	[RAAFY]	R AAFY
RAARY	[RAARY]	R AARY
RAAXY	[RAAXY]	R AAXY
RAAJN	[RAAJN]	R AAJ N
RAAJP	[RAAJP]	R AAJ P
RAAJT	[RAAJT]	R AAJ T
RAWSC	[RAWSC]	R AWS C
RAWSM	[RAWSM]	R AWS M
RAWSN	[RAWSN]	R AWS N
RAWFM	[RAWFM]	R AWF M
RAWFNG	[RAWFNG]	R AWF NG
RAWJNG	[RAWJNG]	R AWJ NG
REJO	[REJO]	R EJO
REJT	[REJT]	R EJ T
RER	[RER]	R ER
REX	[REX]	R EX
REES	[REES]	R EES
REESN	[REESN]	R EES N
REEST	[REEST]	R EES T
REEF	[REEF]	R EEF
REER	[REER]	R EER
REEX	[REEX]	R EEX
REEJ	[REEJ]	R EEJ
REEJT	[REEJT]	R EEJ T
REEJU	[REEJU]	R EEJU
RIR	[RIR]	R IR
RIRA	[RIRA]	R IRA
RIRNH	[RIRNH]	R IR NH
RIJA	[RIJA]	R IJA
RIJCH	[RIJCH]	R IJ CH
RIJN	[RIJN]	R IJ N
RIJT	[RIJT]	R IJ T
ROJI	[ROJI]	R OJI
RORI	[RORI]	R ORI
ROOSC	[ROOSC]	R OOS C
ROOSI	[ROOSI]	R OOSI
ROOSN	[ROOSN]	R OOS N
ROOSNG	[ROOSNG]	R OOS NG
ROOSP	[ROOSP]	R OOS P
ROOST	[ROOST]	R OOS T
ROOF	[ROOF]	R OOF
ROOFI	[ROOFI]	R OOFI
ROOFNG	[ROOFNG]	R OOF NG
ROOR	[ROOR]	R OOR
ROOXI	[ROOXI]	R OOXI
ROOXNG	[ROOXNG]	R OOX NG
ROOJ	[ROOJ]	R OOJ
ROOJC	[ROOJC]	R OOJ C
ROOJN	[ROOJN]	R OOJ N
ROOJNG	[ROOJNG]	R OOJ NG
ROOJP	[ROOJP]	R OOJ P
ROWSM	[ROWSM]	R OWS M
ROWST	[ROWST]	R OWS T
ROWF	[ROWF]	R OWF
ROWFI	[ROWFI]	R OWFI
ROWFN	[ROWFN]	R OWF N
ROWX	[ROWX]	R OWX
ROWXN	[ROWXN]	R OWX N
ROWJ	[ROWJ]	R OWJ
ROWJI	[ROWJI]	R OWJI
ROWJN	[ROWJN]	R OWJ N
ROWJP	[ROWJP]	R OWJ P
RUJC	[RUJC]	R UJ C
RUJNG	[RUJNG]	R UJ NG
RUR	[RUR]	R UR
RURA	[RURA]	R URA
RURI	[RURI]	R URI
RURNG	[RURNG]	R UR NG
RUWSC	[RUWSC]	R UWS C
RUWST	[RUWST]	R UWS T
RUWFNG	[RUWFNG]	R UWF NG
RUWRA	[RUWRA]	R UWRA
RUWXA	[RUWXA]	R UWXA
RUWJA	[RUWJA]	R UWJA
RUWJC	[RUWJC]	R UWJ C
SA	[SA]	S A
SAI	[SAI]	S AI
SAM	[SAM]	S A M
SAN	[SAN]	S A N
SANG	[SANG]	S A NG
SANH	[SANH]	S A NH
SAO	[SAO]	S AO
SAU	[SAU]	S AU
SAY	[SAY]	S AY
SE	[SE]	S E
SEN	[SEN]	S E N
SI	[SI]	S I
SIM	[SIM]	S I M
SINH	[SINH]	S I NH
SIEEU	[SIEEU]	S IEEU
SIEEST	[SIEEST]	S IEES T
SO	[SO]	S O
SOI	[SOI]	S OI
SON	[SON]	S O N
SONG	[SONG]	S O NG
SOAST	[SOAST]	S OAS T
SOAJN	[SOAJN]	S OAJ N
SOAJNG	[SOAJNG]	S OAJ NG
SOAJT	[SOAJT]	S OAJ T
SU	[SU]	S U
SUM	[SUM]	S U M
SUN	[SUN]	S U N
SUNG	[SUNG]	S U NG
SUY	[SUY]	S UY
SUYEERN	[SUYEERN]	S UYEER N
SUYEEXN	[SUYEEXN]	S UYEEX N
SUYST	[SUYST]	S UYS T
SUAAST	[SUAAST]	S UAAS T
SUOOSI	[SUOOSI]	S UOOSI
SUOOST	[SUOOST]	S UOOS T
SAF	[SAF]	S AF
SAFI	[SAFI]	S AFI
SAFM	[SAFM]	S AF M
SAFN	[SAFN]	S AF N
SAFNG	[SAFNG]	S AF NG
SAFNH	[SAFNH]	S AF NH
SAFO	[SAFO]	S AFO
SAS	[SAS]	S AS
SASC	[SASC]	S AS C
SASCH	[SASCH]	S AS CH
SASI	[SASI]	S ASI
SASNG	[SASNG]	S AS NG
SASNH	[SASNH]	S AS NH
SASO	[SASO]	S ASO
SASP	[SASP]	S AS P
SAST	[SAST]	S AS T
SASU	[SASU]	S ASU
SAAM	[SAAM]	S AA M
SAAN	[SAAN]	S AA N
SAAU	[SAAU]	S AAU
SAXI	[SAXI]	S AXI
SEFO	[SEFO]	S EFO
SESC	[SESC]	S ES C
SEST	[SEST]	S ES T
SEEN	[SEEN]	S EE N
SEENH	[SEENH]	S EE NH
SEEU	[SEEU]	S EEU
SIF	[SIF]	S IF
SISNH	[SISNH]	S IS NH
SOF	[SOF]	S OF
SOFNG	[SOFNG]	S OF NG
SOSC	[SOSC]	S OS C
SOSI	[SOSI]	S OSI
SOSN	[SOSN]	S OS N
SOSNG	[SOSNG]	S OS NG
SOST	[SOST]	S OS T
SOO	[SOO]	S OO
SOOI	[SOOI]	S OOI
SOONG	[SOONG]	S OO NG
SOXI	[SOXI]	S OXI
SUFI	[SUFI]	S UFI
SUS	[SUS]	S US
SUSC	[SUSC]	S US C
SUSNG	[SUSNG]	S US NG
SUSP	[SUSP]	S US P
SUST	[SUST]	S US T
SUSY	[SUSY]	S USY
SAWN	[SAWN]	S AW N
SIX	[SIX]	S IX
SUXNG	[SUXNG]	S UX NG
SOW	[SOW]	S OW
SOWM	[SOWM]	S OW M
SOWN	[SOWN]	S OW N
SUW	[SUW]	S UW
SUWA	[SUWA]	S UWA
SUWNG	[SUWNG]	S UW NG
SUWU	[SUWU]	S UWU
SUWOWNG	[SUWOWNG]	S UWOW NG
SUWOWSNG	[SUWOWSNG]	S UWOWS NG
SUWOWST	[SUWOWST]	S UWOWS T
SUWOWFN	[SUWOWFN]	S UWOWF N
SUWOWFNG	[SUWOWFNG]	S UWOWF NG
SUWOWRI	[SUWOWRI]	S UWOWRI
SUWOWJT	[SUWOWJT]	S UWOWJ T
SAJCH	[SAJCH]	S AJ CH
SAJM	[SAJM]	S AJ M
SAJN	[SAJN]	S AJ N
SAJO	[SAJO]	S AJO
SAJP	[SAJP]	S AJ P
SAJT	[SAJT]	S AJ T
SARN	[SARN]	S AR N
SARNG	[SARNG]	S AR NG
SARNH	[SARNH]	S AR NH
SARO	[SARO]	S ARO
SARY	[SARY]	S ARY
SAASM	[SAASM]	S AAS M
SAASU	[SAASU]	S AASU
SAASY	[SAASY]	S AASY
SAAFM	[SAAFM]	S AAF M
SAAFN	[SAAFN]	S AAF N
SAAFU	[SAAFU]	S AAFU
SAARN	[SAARN]	S AAR N
SAARY	[SAARY]	S AARY
SAAXM	[SAAXM]	S AAX M
SAAJP	[SAAJP]	S AAJ P
SAWSC	[SAWSC]	S AWS C
SAWSM	[SAWSM]	S AWS M
SAWSN	[SAWSN]	S AWS N
SAWSNG	[SAWSNG]	S AWS NG
SAWSP	[SAWSP]	S AWS P
SAWST	[SAWST]	S AWS T
SAWXN	[SAWXN]	S AWX N
SAWJC	[SAWJC]	S AWJ C
SEJM	[SEJM]	S EJ M
SEJO	[SEJO]	S EJO
SER	[SER]	S ER
SERN	[SERN]	S ER N
SEX	[SEX]	S EX
SEESP	[SEESP]	S EES P
SEESU	[SEESU]	S EESU
SEEFN	[SEEFN]	S EEF N
SEER	[SEER]	S EER
SEERNH	[SEERNH]	S EER NH
SEEX	[SEEX]	S EEX
SEEJT	[SEEJT]	S EEJ T
SIJT	[SIJT]	S IJ T
SOJ	[SOJ]	S OJ
SOJM	[SOJM]	S OJ M
SOJT	[SOJT]	S OJ T
SOR	[SOR]	S OR
SORI	[SORI]	S ORI
SOOS	[SOOS]	S OOS
SOOSC	[SOOSC]	S OOS C
SOOSNG	[SOOSNG]	S OOS NG
SOOST	[SOOST]	S OOS T
SOOF	[SOOF]	S OOF
SOOFI	[SOOFI]	S OOFI
SOOFN	[SOOFN]	S OOF N
SOOR	[SOOR]	S OOR
SOOX	[SOOX]	S OOX
SOOJ	[SOOJ]	S OOJ
SOOJT	[SOOJT]	S OOJ T
SOWS	[SOWS]	S OWS
SOWSI	[SOWSI]	S OWSI
SOWSM	[SOWSM]	S OWS M
SOWSN	[SOWSN]	S OWS N
SOWST	[SOWST]	S OWS T
SOWF	[SOWF]	S OWF
SOWFM	[SOWFM]	S OWF M
SOWFN	[SOWFN]	S OWF N
SOWR	[SOWR]	S OWR
SOWX	[SOWX]	S OWX
SOWJ	[SOWJ]	S OWJ
SOWJI	[SOWJI]	S OWJI
SUJA	[SUJA]	S UJA
SUJC	[SUJC]	S UJ C
SUJN	[SUJN]	S UJ N
SUJT	[SUJT]	S UJ T
SURA	[SURA]	S URA
SURI	[SURI]	S URI
SUWS	[SUWS]	S UWS
SUWSA	[SUWSA]	S UWSA
SUWSC	[SUWSC]	S UWS C
SUWST	[SUWST]	S UWS T
SUWFNG	[SUWFNG]	S UWF NG
SUWR	[SUWR]	S UWR
SUWRA	[SUWRA]	S UWRA
SUWRNG	[SUWRNG]	S UWR NG
SUWXA	[SUWXA]	S UWXA
SUWXNG	[SUWXNG]	S UWX NG
SUWJ	[SUWJ]	S UWJ
SUWJC	[SUWJC]	S UWJ C
SYX	[SYX]	S YX
T	[T]	T 
TA	[TA]	T A
TAI	[TAI]	T AI
TAM	[TAM]	T A M
TAN	[TAN]	T A N
TANG	[TANG]	T A NG
TANH	[TANH]	T A NH
TAO	[TAO]	T AO
TAY	[TAY]	T AY
TEM	[TEM]	T E M
TEN	[TEN]	T E N
TEO	[TEO]	T EO
THA	[THA]	TH A
THAI	[THAI]	TH AI
THAM	[THAM]	TH A M
THAN	[THAN]	TH A N
THANG	[THANG]	TH A NG
THANH	[THANH]	TH A NH
THAO	[THAO]	TH AO
THAY	[THAY]	TH AY
THE	[THE]	TH E
THEN	[THEN]	TH E N
THEO	[THEO]	TH EO
THI	[THI]	TH I
THIA	[THIA]	TH IA
THIN	[THIN]	TH I N
THINH	[THINH]	TH I NH
THIEEM	[THIEEM]	TH IEE M
THIEEN	[THIEEN]	TH IEE N
THIEENG	[THIEENG]	TH IEE NG
THIEESC	[THIEESC]	TH IEES C
THIEESP	[THIEESP]	TH IEES P
THIEEST	[THIEEST]	TH IEES T
THIEESU	[THIEESU]	TH IEESU
THIEEFM	[THIEEFM]	TH IEEF M
THIEEFN	[THIEEFN]	TH IEEF N
THIEEFU	[THIEEFU]	TH IEEFU
THIEERN	[THIEERN]	TH IEER N
THIEERU	[THIEERU]	TH IEERU
THIEEJN	[THIEEJN]	TH IEEJ N
THIEEJP	[THIEEJP]	TH IEEJ P
THIEEJT	[THIEEJT]	TH IEEJ T
THIEEJU	[THIEEJU]	TH IEEJU
THO	[THO]	TH O
THOA	[THOA]	TH OA
THOANG	[THOANG]	TH OA NG
THOI	[THOI]	TH OI
THON	[THON]	TH O N
THONG	[THONG]	TH O NG
THOASI	[THOASI]	TH OASI
THOASNG	[THOASNG]	TH OAS NG
THOAST	[THOAST]	TH OAS T
THOAWN	[THOAWN]	TH OAW N
THOAJI	[THOAJI]	TH OAJI
THOAJT	[THOAJT]	TH OAJ T
THOAR	[THOAR]	TH OAR
THOARI	[THOARI]	TH OARI
THOARNG	[THOARNG]	TH OAR NG
THOAWST	[THOAWST]	TH OAWS T
THU	[THU]	TH U
THUA	[THUA]	TH UA
THUI	[THUI]	TH UI
THUN	[THUN]	TH U N
THUNG	[THUNG]	TH U NG
THUYEEN	[THUYEEN]	TH UYEE N
THUYEEST	[THUYEEST]	TH UYEES T
THUYEEFN	[THUYEEFN]	TH UYEEF N
THUEE	[THUEE]	TH UEE
THUAAFN	[THUAAFN]	TH UAAF N
THUAAXN	[THUAAXN]	TH UAAX N
THUAAJN	[THUAAJN]	TH UAAJ N
THUAAJT	[THUAAJT]	TH UAAJ T
THUEES	[THUEES]	TH UEES
THUOOSC	[THUOOSC]	TH UOOS C
THUOOFNG	[THUOOFNG]	TH UOOF NG
THUOOJC	[THUOOJC]	TH UOOJ C
THUOWR	[THUOWR]	TH UOWR
THUYR	[THUYR]	TH UYR
THAF	[THAF]	TH AF
THAFI	[THAFI]	TH AFI
THAFNH	[THAFNH]	TH AF NH
THAFO	[THAFO]	TH AFO
THASC	[THASC]	TH AS C
THASCH	[THASCH]	TH AS CH
THASI	[THASI]	TH ASI
THASM	[THASM]	TH AS M
THASN	[THASN]	TH AS N
THASNG	[THASNG]	TH AS NG
THASNH	[THASNH]	TH AS NH
THASO	[THASO]	TH ASO
THASP	[THASP]	TH AS P
THAAM	[THAAM]	TH AA M
THAAN	[THAAN]	TH AA N
THAAU	[THAAU]	TH AAU
THAAY	[THAAY]	TH AAY
THAXI	[THAXI]	TH AXI
THEFM	[THEFM]	TH EF M
THEFO	[THEFO]	TH EFO
THESP	[THESP]	TH ES P
THEST	[THEST]	TH ES T
THEE	[THEE]	TH EE
THEEM	[THEEM]	TH EE M
THEENH	[THEENH]	TH EE NH
THEEU	[THEEU]	TH EEU
THIF	[THIF]	TH IF
THIFA	[THIFA]	TH IFA
THIFNH	[THIFNH]	TH IF NH
THIFU	[THIFU]	TH IFU
THIS	[THIS]	TH IS
THISA	[THISA]	TH ISA
THISCH	[THISCH]	TH IS CH
THISM	[THISM]	TH IS M
THISN	[THISN]	TH IS N
THISNH	[THISNH]	TH IS NH
THISP	[THISP]	TH IS P
THIST	[THIST]	TH IS T
THOF	[THOF]	TH OF
THOFI	[THOFI]	TH OFI
THOFNG	[THOFNG]	TH OF NG
THOS	[THOS]	TH OS
THOSA	[THOSA]	TH OSA
THOSC	[THOSC]	TH OS C
THOSI	[THOSI]	TH OSI
THOSP	[THOSP]	TH OS P
THOST	[THOST]	TH OS T
THOO	[THOO]	TH OO
THOOI	[THOOI]	TH OOI
THOON	[THOON]	TH OO N
THOONG	[THOONG]	TH OO NG
THOXNG	[THOXNG]	TH OX NG
THUF	[THUF]	TH UF
THUFM	[THUFM]	TH UF M
THUFNG	[THUFNG]	TH UF NG
THUFY	[THUFY]	TH UFY
THUS	[THUS]	TH US
THUSC	[THUSC]	TH US C
THUSNG	[THUSNG]	TH US NG
THUST	[THUST]	TH US T
THUSY	[THUSY]	TH USY
THAWM	[THAWM]	TH AW M
THAWNG	[THAWNG]	TH AW NG
THUXNG	[THUXNG]	TH UX NG
THOW	[THOW]	TH OW
THOWI	[THOWI]	TH OWI
THOWM	[THOWM]	TH OW M
THUW	[THUW]	TH UW
THUWA	[THUWA]	TH UWA
THUWOWNG	[THUWOWNG]	TH UWOW NG
THUWOWSC	[THUWOWSC]	TH UWOWS C
THUWOWFNG	[THUWOWFNG]	TH UWOWF NG
THUWOWRNG	[THUWOWRNG]	TH UWOWR NG
THUWOWXI	[THUWOWXI]	TH UWOWXI
THUWOWXN	[THUWOWXN]	TH UWOWX N
THUWOWJC	[THUWOWJC]	TH UWOWJ C
THUWOWJNG	[THUWOWJNG]	TH UWOWJ NG
THAJC	[THAJC]	TH AJ C
THAJCH	[THAJCH]	TH AJ CH
THAJNH	[THAJNH]	TH AJ NH
THAJO	[THAJO]	TH AJO
THAR	[THAR]	TH AR
THARI	[THARI]	TH ARI
THARM	[THARM]	TH AR M
THARN	[THARN]	TH AR N
THARNG	[THARNG]	TH AR NG
THARNH	[THARNH]	TH AR NH
THARO	[THARO]	TH ARO
THARY	[THARY]	TH ARY
THAASM	[THAASM]	TH AAS M
THAASP	[THAASP]	TH AAS P
THAAST	[THAAST]	TH AAS T
THAASU	[THAASU]	TH AASU
THAASY	[THAASY]	TH AASY
THAAFM	[THAAFM]	TH AAF M
THAAFN	[THAAFN]	TH AAF N
THAAFU	[THAAFU]	TH AAFU
THAAFY	[THAAFY]	TH AAFY
THAARM	[THAARM]	TH AAR M
THAARN	[THAARN]	TH AAR N
THAAXM	[THAAXM]	TH AAX M
THAAXN	[THAAXN]	TH AAX N
THAAJM	[THAAJM]	TH AAJ M
THAAJN	[THAAJN]	TH AAJ N
THAAJP	[THAAJP]	TH AAJ P
THAAJT	[THAAJT]	TH AAJ T
THAWSC	[THAWSC]	TH AWS C
THAWSN	[THAWSN]	TH AWS N
THAWSNG	[THAWSNG]	TH AWS NG
THAWSP	[THAWSP]	TH AWS P
THAWST	[THAWST]	TH AWS T
THAWFN	[THAWFN]	TH AWF N
THAWFNG	[THAWFNG]	TH AWF NG
THAWRM	[THAWRM]	TH AWR M
THAWRNG	[THAWRNG]	TH AWR NG
THER	[THER]	TH ER
THEES	[THEES]	TH EES
THEESCH	[THEESCH]	TH EES CH
THEESP	[THEESP]	TH EES P
THEEF	[THEEF]	TH EEF
THEEFM	[THEEFM]	TH EEF M
THEEFU	[THEEFU]	TH EEFU
THEER	[THEER]	TH EER
THEEJ	[THEEJ]	TH EEJ
THIR	[THIR]	TH IR
THIRNH	[THIRNH]	TH IR NH
THIJ	[THIJ]	TH IJ
THIJCH	[THIJCH]	TH IJ CH
THIJNH	[THIJNH]	TH IJ NH
THIJT	[THIJT]	TH IJ T
THIJU	[THIJU]	TH IJU
THOJ	[THOJ]	TH OJ
THOJC	[THOJC]	TH OJ C
THOJT	[THOJT]	TH OJ T
THOR	[THOR]	TH OR
THORA	[THORA]	TH ORA
THORI	[THORI]	TH ORI
THORM	[THORM]	TH OR M
THOOS	[THOOS]	TH OOS
THOOSI	[THOOSI]	TH OOSI
THOOSN	[THOOSN]	TH OOS N
THOOSNG	[THOOSNG]	TH OOS NG
THOOST	[THOOST]	TH OOS T
THOOF	[THOOF]	TH OOF
THOOFI	[THOOFI]	TH OOFI
THOOFN	[THOOFN]	TH OOF N
THOOR	[THOOR]	TH OOR
THOORI	[THOORI]	TH OORI
THOWSI	[THOWSI]	TH OWSI
THOWST	[THOWST]	TH OWS T
THOWF	[THOWF]	TH OWF
THOWFI	[THOWFI]	TH OWFI
THOWR	[THOWR]	TH OWR
THOWJ	[THOWJ]	TH OWJ
THUJ	[THUJ]	TH UJ
THUJC	[THUJC]	TH UJ C
THUJNG	[THUJNG]	TH UJ NG
THUJP	[THUJP]	TH UJ P
THUJT	[THUJT]	TH UJ T
THUJY	[THUJY]	TH UJY
THUR	[THUR]	TH UR
THURA	[THURA]	TH URA
THURI	[THURI]	TH URI
THURNG	[THURNG]	TH UR NG
THURY	[THURY]	TH URY
THUWS	[THUWS]	TH UWS
THUWSC	[THUWSC]	TH UWS C
THUWF	[THUWF]	TH UWF
THUWFA	[THUWFA]	TH UWFA
THUWFNG	[THUWFNG]	TH UWF NG
THUWR	[THUWR]	TH UWR
THUWRA	[THUWRA]	TH UWRA
THUWXNG	[THUWXNG]	TH UWX NG
THUWJ	[THUWJ]	TH UWJ
THUWJC	[THUWJC]	TH UWJ C
TI	[TI]	T I
TIA	[TIA]	T IA
TIM	[TIM]	T I M
TIN	[TIN]	T I N
TINH	[TINH]	T I NH
TIU	[TIU]	T IU
TIEEM	[TIEEM]	T IEE M
TIEEN	[TIEEN]	T IEE N
TIEEU	[TIEEU]	T IEEU
TIEESC	[TIEESC]	T IEES C
TIEESM	[TIEESM]	T IEES M
TIEESN	[TIEESN]	T IEES N
TIEESNG	[TIEESNG]	T IEES NG
TIEESP	[TIEESP]	T IEES P
TIEEST	[TIEEST]	T IEES T
TIEESU	[TIEESU]	T IEESU
TIEEFM	[TIEEFM]	T IEEF M
TIEEFN	[TIEEFN]	T IEEF N
TIEERU	[TIEERU]	T IEERU
TIEEXN	[TIEEXN]	T IEEX N
TIEEXU	[TIEEXU]	T IEEXU
TIEEJC	[TIEEJC]	T IEEJ C
TIEEJM	[TIEEJM]	T IEEJ M
TIEEJN	[TIEEJN]	T IEEJ N
TO	[TO]	T O
TOA	[TOA]	T OA
TOAN	[TOAN]	T OA N
TOANH	[TOANH]	T OA NH
TOE	[TOE]	T OE
TONG	[TONG]	T O NG
TOP	[TOP]	T O P
TOAF	[TOAF]	T OAF
TOAFI	[TOAFI]	T OAFI
TOAFN	[TOAFN]	T OAF N
TOASI	[TOASI]	T OASI
TOASN	[TOASN]	T OAS N
TOAST	[TOAST]	T OAS T
TOEST	[TOEST]	T OES T
TOAJC	[TOAJC]	T OAJ C
TOAR	[TOAR]	T OAR
TOARN	[TOARN]	T OAR N
TOEJT	[TOEJT]	T OEJ T
TRA	[TRA]	TR A
TRAI	[TRAI]	TR AI
TRANG	[TRANG]	TR A NG
TRANH	[TRANH]	TR A NH
TRAO	[TRAO]	TR AO
TRAU	[TRAU]	TR AU
TRE	[TRE]	TR E
TREO	[TREO]	TR EO
TRI	[TRI]	TR I
TRINH	[TRINH]	TR I NH
TRIEENG	[TRIEENG]	TR IEE NG
TRIEEST	[TRIEEST]	TR IEES T
TRIEEFN	[TRIEEFN]	TR IEEF N
TRIEEFNG	[TRIEEFNG]	TR IEEF NG
TRIEEFU	[TRIEEFU]	TR IEEFU
TRIEERN	[TRIEERN]	TR IEER N
TRIEEJNG	[TRIEEJNG]	TR IEEJ NG
TRIEEJT	[TRIEEJT]	TR IEEJ T
TRIEEJU	[TRIEEJU]	TR IEEJU
TRO	[TRO]	TR O
TRONG	[TRONG]	TR O NG
TRU	[TRU]	TR U
TRUNG	[TRUNG]	TR U NG
TRUY	[TRUY]	TR UY
TRUYEEFN	[TRUYEEFN]	TR UYEEF N
TRUYEEJN	[TRUYEEJN]	TR UYEEJ N
TRUAAN	[TRUAAN]	TR UAA N
TRUAAJT	[TRUAAJT]	TR UAAJ T
TRUOOFNG	[TRUOOFNG]	TR UOOF NG
TRAF	[TRAF]	TR AF
TRAFI	[TRAFI]	TR AFI
TRAFM	[TRAFM]	TR AF M
TRAFN	[TRAFN]	TR AF N
TRAFNG	[TRAFNG]	TR AF NG
TRAFNH	[TRAFNH]	TR AF NH
TRAFO	[TRAFO]	TR AFO
TRAS	[TRAS]	TR AS
TRASCH	[TRASCH]	TR AS CH
TRASI	[TRASI]	TR ASI
TRASM	[TRASM]	TR AS M
TRASN	[TRASN]	TR AS N
TRASNG	[TRASNG]	TR AS NG
TRASNH	[TRASNH]	TR AS NH
TRASO	[TRASO]	TR ASO
TRASP	[TRASP]	TR AS P
TRAST	[TRAST]	TR AS T
TRAAM	[TRAAM]	TR AA M
TRAAN	[TRAAN]	TR AA N
TRAAU	[TRAAU]	TR AAU
TRAX	[TRAX]	TR AX
TRAXI	[TRAXI]	TR AXI
TREFO	[TREFO]	TR EFO
TRESM	[TRESM]	TR ES M
TRESO	[TRESO]	TR ESO
TREE	[TREE]	TR EE
TREEN	[TREEN]	TR EE N
TREEU	[TREEU]	TR EEU
TRIF	[TRIF]	TR IF
TRIFNH	[TRIFNH]	TR IF NH
TRIFU	[TRIFU]	TR IFU
TRIS	[TRIS]	TR IS
TRISCH	[TRISCH]	TR IS CH
TROF	[TROF]	TR OF
TROFN	[TROFN]	TR OF N
TROFNG	[TROFNG]	TR OF NG
TROSC	[TROSC]	TR OS C
TROSNG	[TROSNG]	TR OS NG
TROST	[TROST]	TR OS T
TROOI	[TROOI]	TR OOI
TROOM	[TROOM]	TR OO M
TROONG	[TROONG]	TR OO NG
TROXN	[TROXN]	TR OX N
TRUF	[TRUF]	TR UF
TRUFI	[TRUFI]	TR UFI
TRUFM	[TRUFM]	TR UF M
TRUFN	[TRUFN]	TR UF N
TRUFNG	[TRUFNG]	TR UF NG
TRUS	[TRUS]	TR US
TRUSC	[TRUSC]	TR US C
TRUSM	[TRUSM]	TR US M
TRUSNG	[TRUSNG]	TR US NG
TRUST	[TRUST]	TR US T
TRAWM	[TRAWM]	TR AW M
TRAWN	[TRAWN]	TR AW N
TRAWNG	[TRAWNG]	TR AW NG
TRIX	[TRIX]	TR IX
TRIXU	[TRIXU]	TR IXU
TRUXNG	[TRUXNG]	TR UX NG
TROW	[TROW]	TR OW
TROWI	[TROWI]	TR OWI
TROWN	[TROWN]	TR OW N
TRUW	[TRUW]	TR UW
TRUWA	[TRUWA]	TR UWA
TRUWNG	[TRUWNG]	TR UW NG
TRUWOWNG	[TRUWOWNG]	TR UWOW NG
TRUWOWSC	[TRUWOWSC]	TR UWOWS C
TRUWOWSNG	[TRUWOWSNG]	TR UWOWS NG
TRUWOWFNG	[TRUWOWFNG]	TR UWOWF NG
TRUWOWRNG	[TRUWOWRNG]	TR UWOWR NG
TRUWOWXNG	[TRUWOWXNG]	TR UWOWX NG
TRUWOWJT	[TRUWOWJT]	TR UWOWJ T
TRAJC	[TRAJC]	TR AJ C
TRAJI	[TRAJI]	TR AJI
TRAJM	[TRAJM]	TR AJ M
TRAJNG	[TRAJNG]	TR AJ NG
TRAR	[TRAR]	TR AR
TRARI	[TRARI]	TR ARI
TRARO	[TRARO]	TR ARO
TRARU	[TRARU]	TR ARU
TRAASN	[TRAASN]	TR AAS N
TRAASU	[TRAASU]	TR AASU
TRAAFM	[TRAAFM]	TR AAF M
TRAAFN	[TRAAFN]	TR AAF N
TRAAFU	[TRAAFU]	TR AAFU
TRAAFY	[TRAAFY]	TR AAFY
TRAAXM	[TRAAXM]	TR AAX M
TRAAJN	[TRAAJN]	TR AAJ N
TRAAJT	[TRAAJT]	TR AAJ T
TRAWSC	[TRAWSC]	TR AWS C
TRAWSNG	[TRAWSNG]	TR AWS NG
TRAWFN	[TRAWFN]	TR AWF N
TRAWJC	[TRAWJC]	TR AWJ C
TRAWJN	[TRAWJN]	TR AWJ N
TREJO	[TREJO]	TR EJO
TRER	[TRER]	TR ER
TREXN	[TREXN]	TR EX N
TREESCH	[TREESCH]	TR EES CH
TREEF	[TREEF]	TR EEF
TREEX	[TREEX]	TR EEX
TREEJ	[TREEJ]	TR EEJ
TREEJT	[TREEJT]	TR EEJ T
TRIJ	[TRIJ]	TR IJ
TRIJA	[TRIJA]	TR IJA
TRIJCH	[TRIJCH]	TR IJ CH
TRIJNH	[TRIJNH]	TR IJ NH
TRIJT	[TRIJT]	TR IJ T
TROJ	[TROJ]	TR OJ
TROJC	[TROJC]	TR OJ C
TROJI	[TROJI]	TR OJI
TROJN	[TROJN]	TR OJ N
TROJNG	[TROJNG]	TR OJ NG
TROJT	[TROJT]	TR OJ T
TROR	[TROR]	TR OR
TROOSN	[TROOSN]	TR OOS N
TROOSNG	[TROOSNG]	TR OOS NG
TROOF	[TROOF]	TR OOF
TROOFI	[TROOFI]	TR OOFI
TROOFNG	[TROOFNG]	TR OOF NG
TROOR	[TROOR]	TR OOR
TROOJ	[TROOJ]	TR OOJ
TROOJM	[TROOJM]	TR OOJ M
TROOJN	[TROOJN]	TR OOJ N
TROWS	[TROWS]	TR OWS
TROWSN	[TROWSN]	TR OWS N
TROWF	[TROWF]	TR OWF
TROWFI	[TROWFI]	TR OWFI
TROWR	[TROWR]	TR OWR
TROWJ	[TROWJ]	TR OWJ
TROWJN	[TROWJN]	TR OWJ N
TROWJT	[TROWJT]	TR OWJ T
TRUJ	[TRUJ]	TR UJ
TRUJA	[TRUJA]	TR UJA
TRUJC	[TRUJC]	TR UJ C
TRUJI	[TRUJI]	TR UJI
TRUJT	[TRUJT]	TR UJ T
TRUJY	[TRUJY]	TR UJY
TRUWS	[TRUWS]	TR UWS
TRUWSNG	[TRUWSNG]	TR UWS NG
TRUWF	[TRUWF]	TR UWF
TRUWFNG	[TRUWFNG]	TR UWF NG
TRUWRNG	[TRUWRNG]	TR UWR NG
TRUWX	[TRUWX]	TR UWX
TRUWJC	[TRUWJC]	TR UWJ C
TU	[TU]	T U
TUA	[TUA]	T UA
TUI	[TUI]	T UI
TUM	[TUM]	T U M
TUNG	[TUNG]	T U NG
TUY	[TUY]	T UY
TUYEEN	[TUYEEN]	T UYEE N
TUYEESN	[TUYEESN]	T UYEES N
TUYEEST	[TUYEEST]	T UYEES T
TUYEEFN	[TUYEEFN]	T UYEEF N
TUYEERN	[TUYEERN]	T UYEER N
TUYEEJT	[TUYEEJT]	T UYEEJ T
TUAAN	[TUAAN]	T UAA N
TUOON	[TUOON]	T UOO N
TUOONG	[TUOONG]	T UOO NG
TUAASN	[TUAASN]	T UAAS N
TUAAFN	[TUAAFN]	T UAAF N
TUEES	[TUEES]	T UEES
TUEEJ	[TUEEJ]	T UEEJ
TUEEJCH	[TUEEJCH]	T UEEJ CH
TUOOST	[TUOOST]	T UOOS T
TUOOFN	[TUOOFN]	T UOOF N
TUOOFNG	[TUOOFNG]	T UOOF NG
TUOORI	[TUOORI]	T UOORI
TUOOJT	[TUOOJT]	T UOOJ T
TUYF	[TUYF]	T UYF
TY	[TY]	T Y
TAF	[TAF]	T AF
TAFI	[TAFI]	T AFI
TAFN	[TAFN]	T AF N
TAFNG	[TAFNG]	T AF NG
TAFNH	[TAFNH]	T AF NH
TAFO	[TAFO]	T AFO
TAFU	[TAFU]	T AFU
TAFY	[TAFY]	T AFY
TAS	[TAS]	T AS
TASC	[TASC]	T AS C
TASCH	[TASCH]	T AS CH
TASI	[TASI]	T ASI
TASM	[TASM]	T AS M
TASN	[TASN]	T AS N
TASNG	[TASNG]	T AS NG
TASNH	[TASNH]	T AS NH
TASO	[TASO]	T ASO
TASP	[TASP]	T AS P
TAST	[TAST]	T AS T
TASY	[TASY]	T ASY
TAAM	[TAAM]	T AA M
TAAN	[TAAN]	T AA N
TAAY	[TAAY]	T AAY
TAX	[TAX]	T AX
TAXI	[TAXI]	T AXI
TEF	[TEF]	T EF
TEFN	[TEFN]	T EF N
TES	[TES]	T ES
TESC	[TESC]	T ES C
TESM	[TESM]	T ES M
TESN	[TESN]	T ES N
TESP	[TESP]	T ES P
TEST	[TEST]	T ES T
TEE	[TEE]	T EE
TEEN	[TEEN]	T EE N
TIF	[TIF]	T IF
TIFM	[TIFM]	T IF M
TIFNH	[TIFNH]	T IF NH
TIS	[TIS]	T IS
TISA	[TISA]	T ISA
TISCH	[TISCH]	T IS CH
TISM	[TISM]	T IS M
TISN	[TISN]	T IS N
TISNH	[TISNH]	T IS NH
TISP	[TISP]	T IS P
TIST	[TIST]	T IS T
TISU	[TISU]	T ISU
TOF	[TOF]	T OF
TOFA	[TOFA]	T OFA
TOFE	[TOFE]	T OFE
TOFI	[TOFI]	T OFI
TOFM	[TOFM]	T OF M
TOFNG	[TOFNG]	T OF NG
TOSC	[TOSC]	T OS C
TOSE	[TOSE]	T OSE
TOSM	[TOSM]	T OS M
TOSP	[TOSP]	T OS P
TOO	[TOO]	T OO
TOOI	[TOOI]	T OOI
TOOM	[TOOM]	T OO M
TOON	[TOON]	T OO N
TOONG	[TOONG]	T OO NG
TUF	[TUF]	T UF
TUFNG	[TUFNG]	T UF NG
TUFY	[TUFY]	T UFY
TUS	[TUS]	T US
TUSC	[TUSC]	T US C
TUSI	[TUSI]	T USI
TUSM	[TUSM]	T US M
TUSNG	[TUSNG]	T US NG
TUST	[TUST]	T US T
TUSY	[TUSY]	T USY
TYS	[TYS]	T YS
TAWM	[TAWM]	T AW M
TAWN	[TAWN]	T AW N
TAWNG	[TAWNG]	T AW NG
TIXNH	[TIXNH]	T IX NH
TUXM	[TUXM]	T UX M
TOW	[TOW]	T OW
TOWI	[TOWI]	T OWI
TUW	[TUW]	T UW
TUWA	[TUWA]	T UWA
TUWNG	[TUWNG]	T UW NG
TUWOWI	[TUWOWI]	T UWOWI
TUWOWM	[TUWOWM]	T UWOW M
TUWOWNG	[TUWOWNG]	T UWOW NG
TUWOWSC	[TUWOWSC]	T UWOWS C
TUWOWSI	[TUWOWSI]	T UWOWSI
TUWOWSNG	[TUWOWSNG]	T UWOWS NG
TUWOWFM	[TUWOWFM]	T UWOWF M
TUWOWFNG	[TUWOWFNG]	T UWOWF NG
TUWOWFU	[TUWOWFU]	T UWOWFU
TUWOWRI	[TUWOWRI]	T UWOWRI
TUWOWRNG	[TUWOWRNG]	T UWOWR NG
TUWOWJNG	[TUWOWJNG]	T UWOWJ NG
TUWOWJP	[TUWOWJP]	T UWOWJ P
TAJ	[TAJ]	T AJ
TAJCH	[TAJCH]	T AJ CH
TAJI	[TAJI]	T AJI
TAJM	[TAJM]	T AJ M
TAJNG	[TAJNG]	T AJ NG
TAJO	[TAJO]	T AJO
TAJP	[TAJP]	T AJ P
TAJT	[TAJT]	T AJ T
TAR	[TAR]	T AR
TARI	[TARI]	T ARI
TARN	[TARN]	T AR N
TARNG	[TARNG]	T AR NG
TARO	[TARO]	T ARO
TAASC	[TAASC]	T AAS C
TAASM	[TAASM]	T AAS M
TAASN	[TAASN]	T AAS N
TAASP	[TAASP]	T AAS P
TAAST	[TAAST]	T AAS T
TAASU	[TAASU]	T AASU
TAASY	[TAASY]	T AASY
TAAFM	[TAAFM]	T AAF M
TAAFN	[TAAFN]	T AAF N
TAAFNG	[TAAFNG]	T AAF NG
TAAFY	[TAAFY]	T AAFY
TAARM	[TAARM]	T AAR M
TAARN	[TAARN]	T AAR N
TAARY	[TAARY]	T AARY
TAAJM	[TAAJM]	T AAJ M
TAAJN	[TAAJN]	T AAJ N
TAAJP	[TAAJP]	T AAJ P
TAAJT	[TAAJT]	T AAJ T
TAWSC	[TAWSC]	T AWS C
TAWSM	[TAWSM]	T AWS M
TAWSN	[TAWSN]	T AWS N
TAWST	[TAWST]	T AWS T
TAWFM	[TAWFM]	T AWF M
TAWRN	[TAWRN]	T AWR N
TAWJC	[TAWJC]	T AWJ C
TAWJNG	[TAWJNG]	T AWJ NG
TEJO	[TEJO]	T EJO
TEJP	[TEJP]	T EJ P
TER	[TER]	T ER
TEES	[TEES]	T EES
TEEST	[TEEST]	T EES T
TEESU	[TEESU]	T EESU
TEER	[TEER]	T EER
TEEX	[TEEX]	T EEX
TEEXNH	[TEEXNH]	T EEX NH
TEEJ	[TEEJ]	T EEJ
TEEJP	[TEEJP]	T EEJ P
TIR	[TIR]	T IR
TIRA	[TIRA]	T IRA
TIRM	[TIRM]	T IR M
TIRNH	[TIRNH]	T IR NH
TIJ	[TIJ]	T IJ
TIJCH	[TIJCH]	T IJ CH
TIJNH	[TIJNH]	T IJ NH
TOJA	[TOJA]	T OJA
TOJC	[TOJC]	T OJ C
TOJP	[TOJP]	T OJ P
TOR	[TOR]	T OR
TORA	[TORA]	T ORA
TORI	[TORI]	T ORI
TOOS	[TOOS]	T OOS
TOOSC	[TOOSC]	T OOS C
TOOSI	[TOOSI]	T OOSI
TOOSN	[TOOSN]	T OOS N
TOOSNG	[TOOSNG]	T OOS NG
TOOSP	[TOOSP]	T OOS P
TOOST	[TOOST]	T OOS T
TOOFI	[TOOFI]	T OOFI
TOOFN	[TOOFN]	T OOF N
TOOR	[TOOR]	T OOR
TOORN	[TOORN]	T OOR N
TOORNG	[TOORNG]	T OOR NG
TOOJC	[TOOJC]	T OOJ C
TOOJI	[TOOJI]	T OOJI
TOOJT	[TOOJT]	T OOJ T
TOWS	[TOWS]	T OWS
TOWSI	[TOWSI]	T OWSI
TOWSN	[TOWSN]	T OWS N
TOWF	[TOWF]	T OWF
TOWRM	[TOWRM]	T OWR M
TOWJ	[TOWJ]	T OWJ
TOWJP	[TOWJP]	T OWJ P
TUJ	[TUJ]	T UJ
TUJC	[TUJC]	T UJ C
TUJI	[TUJI]	T UJI
TUJM	[TUJM]	T UJ M
TUJNG	[TUJNG]	T UJ NG
TUJT	[TUJT]	T UJ T
TUJY	[TUJY]	T UJY
TUR	[TUR]	T UR
TURI	[TURI]	T URI
TURM	[TURM]	T UR M
TURN	[TURN]	T UR N
TURY	[TURY]	T URY
TUWS	[TUWS]	T UWS
TUWSC	[TUWSC]	T UWS C
TUWF	[TUWF]	T UWF
TUWFNG	[TUWFNG]	T UWF NG
TUWR	[TUWR]	T UWR
TUWRA	[TUWRA]	T UWRA
TUWRU	[TUWRU]	T UWRU
TUWJ	[TUWJ]	T UWJ
TUWJA	[TUWJA]	T UWJA
TUWJU	[TUWJU]	T UWJU
TYJ	[TYJ]	T YJ
TYR	[TYR]	T YR
U	[U]	U
UNG	[UNG]	U NG
UY	[UY]	UY
UYEEN	[UYEEN]	UYEE N
UYEERN	[UYEERN]	UYEER N
UAAST	[UAAST]	UAAS T
UEES	[UEES]	UEES
UEER	[UEER]	UEER
UOOSN	[UOOSN]	UOOS N
UOOSNG	[UOOSNG]	UOOS NG
UOOJT	[UOOJT]	UOOJ T
UYJCH	[UYJCH]	UYJ CH
UYR	[UYR]	UYR
V	[V]	V 
VA	[VA]	V A
VAI	[VAI]	V AI
VAN	[VAN]	V A N
VANG	[VANG]	V A NG
VANH	[VANH]	V A NH
VAO	[VAO]	V AO
VAY	[VAY]	V AY
VE	[VE]	V E
VEN	[VEN]	V E N
VEO	[VEO]	V EO
VI	[VI]	V I
VINH	[VINH]	V I NH
VIEEM	[VIEEM]	V IEE M
VIEEN	[VIEEN]	V IEE N
VIEESNG	[VIEESNG]	V IEES NG
VIEEST	[VIEEST]	V IEES T
VIEEFN	[VIEEFN]	V IEEF N
VIEERN	[VIEERN]	V IEER N
VIEEXN	[VIEEXN]	V IEEX N
VIEEJC	[VIEEJC]	V IEEJ C
VIEEJN	[VIEEJN]	V IEEJ N
VIEEJT	[VIEEJT]	V IEEJ T
VO	[VO]	V O
VOI	[VOI]	V OI
VON	[VON]	V O N
VONG	[VONG]	V O NG
VU	[VU]	V U
VUA	[VUA]	V UA
VUI	[VUI]	V UI
VUN	[VUN]	V U N
VUNG	[VUNG]	V U NG
VUOONG	[VUOONG]	V UOO NG
VUOOST	[VUOOST]	V UOOS T
VUOOJT	[VUOOJT]	V UOOJ T
VY	[VY]	V Y
VAF	[VAF]	V AF
VAFI	[VAFI]	V AFI
VAFN	[VAFN]	V AF N
VAFNG	[VAFNG]	V AF NG
VAFNH	[VAFNH]	V AF NH
VAFO	[VAFO]	V AFO
VAFY	[VAFY]	V AFY
VAS	[VAS]	V AS
VASC	[VASC]	V AS C
VASCH	[VASCH]	V AS CH
VASI	[VASI]	V ASI
VASN	[VASN]	V AS N
VASNG	[VASNG]	V AS NG
VASNH	[VASNH]	V AS NH
VAST	[VAST]	V AS T
VASY	[VASY]	V ASY
VAAN	[VAAN]	V AA N
VAANG	[VAANG]	V AA NG
VAAY	[VAAY]	V AAY
VAX	[VAX]	V AX
VAXI	[VAXI]	V AXI
VAXNH	[VAXNH]	V AX NH
VEFO	[VEFO]	V EFO
VES	[VES]	V ES
VESN	[VESN]	V ES N
VEST	[VEST]	V ES T
VEE	[VEE]	V EE
VEEN	[VEEN]	V EE N
VEENH	[VEENH]	V EE NH
VIF	[VIF]	V IF
VIS	[VIS]	V IS
VISA	[VISA]	V ISA
VIST	[VIST]	V IS T
VISU	[VISU]	V ISU
VOF	[VOF]	V OF
VOFI	[VOFI]	V OFI
VOFM	[VOFM]	V OF M
VOFNG	[VOFNG]	V OF NG
VOS	[VOS]	V OS
VOSC	[VOSC]	V OS C
VOST	[VOST]	V OS T
VOO	[VOO]	V OO
VOOI	[VOOI]	V OOI
VOONG	[VOONG]	V OO NG
VOX	[VOX]	V OX
VOXNG	[VOXNG]	V OX NG
VUF	[VUF]	V UF
VUFI	[VUFI]	V UFI
VUFN	[VUFN]	V UF N
VUFNG	[VUFNG]	V UF NG
VUS	[VUS]	V US
VUST	[VUST]	V US T
VAWN	[VAWN]	V AW N
VAWNG	[VAWNG]	V AW NG
VIX	[VIX]	V IX
VIXNH	[VIXNH]	V IX NH
VUX	[VUX]	V UX
VUXNG	[VUXNG]	V UX NG
VOW	[VOW]	V OW
VUWOWN	[VUWOWN]	V UWOW N
VUWOWNG	[VUWOWNG]	V UWOW NG
VUWOWSNG	[VUWOWSNG]	V UWOWS NG
VUWOWFN	[VUWOWFN]	V UWOWF N
VUWOWRNG	[VUWOWRNG]	V UWOWR NG
VUWOWJNG	[VUWOWJNG]	V UWOWJ NG
VUWOWJT	[VUWOWJT]	V UWOWJ T
VAJ	[VAJ]	V AJ
VAJC	[VAJC]	V AJ C
VAJCH	[VAJCH]	V AJ CH
VAJM	[VAJM]	V AJ M
VAJN	[VAJN]	V AJ N
VAJT	[VAJT]	V AJ T
VAR	[VAR]	V AR
VARI	[VARI]	V ARI
VARNG	[VARNG]	V AR NG
VARY	[VARY]	V ARY
VAASN	[VAASN]	V AAS N
VAASP	[VAASP]	V AAS P
VAAST	[VAAST]	V AAS T
VAASU	[VAASU]	V AASU
VAASY	[VAASY]	V AASY
VAAFN	[VAAFN]	V AAF N
VAAFNG	[VAAFNG]	V AAF NG
VAAFY	[VAAFY]	V AAFY
VAARN	[VAARN]	V AAR N
VAARY	[VAARY]	V AARY
VAAXN	[VAAXN]	V AAX N
VAAXY	[VAAXY]	V AAXY
VAAJN	[VAAJN]	V AAJ N
VAAJT	[VAAJT]	V AAJ T
VAAJY	[VAAJY]	V AAJY
VAWSC	[VAWSC]	V AWS C
VAWSN	[VAWSN]	V AWS N
VAWSNG	[VAWSNG]	V AWS NG
VAWST	[VAWST]	V AWS T
VAWFN	[VAWFN]	V AWF N
VAWFNG	[VAWFNG]	V AWF NG
VAWRNG	[VAWRNG]	V AWR NG
VAWJC	[VAWJC]	V AWJ C
VAWJN	[VAWJN]	V AWJ N
VAWJT	[VAWJT]	V AWJ T
VEJN	[VEJN]	V EJ N
VEJO	[VEJO]	V EJO
VEJT	[VEJT]	V EJ T
VER	[VER]	V ER
VEX	[VEX]	V EX
VEES	[VEES]	V EES
VEESCH	[VEESCH]	V EES CH
VEEST	[VEEST]	V EES T
VEEF	[VEEF]	V EEF
VEEJ	[VEEJ]	V EEJ
VEEJN	[VEEJN]	V EEJ N
VEEJT	[VEEJT]	V EEJ T
VIR	[VIR]	V IR
VIRA	[VIRA]	V IRA
VIJ	[VIJ]	V IJ
VIJM	[VIJM]	V IJ M
VIJN	[VIJN]	V IJ N
VIJNH	[VIJNH]	V IJ NH
VIJT	[VIJT]	V IJ T
VOJNG	[VOJNG]	V OJ NG
VOJT	[VOJT]	V OJ T
VOR	[VOR]	V OR
VORN	[VORN]	V OR N
VOOSN	[VOOSN]	V OOS N
VOOFNG	[VOOFNG]	V OOF NG
VOOX	[VOOX]	V OOX
VOOJI	[VOOJI]	V OOJI
VOWS	[VOWS]	V OWS
VOWSI	[VOWSI]	V OWSI
VOWST	[VOWST]	V OWS T
VOWF	[VOWF]	V OWF
VOWFI	[VOWFI]	V OWFI
VOWFN	[VOWFN]	V OWF N
VOWR	[VOWR]	V OWR
VOWRN	[VOWRN]	V OWR N
VOWX	[VOWX]	V OWX
VOWJ	[VOWJ]	V OWJ
VOWJI	[VOWJI]	V OWJI
VOWJT	[VOWJT]	V OWJ T
VUJ	[VUJ]	V UJ
VUJN	[VUJN]	V UJ N
VUJNG	[VUJNG]	V UJ NG
VUJT	[VUJT]	V UJ T
VUWST	[VUWST]	V UWS T
VUWFA	[VUWFA]	V UWFA
VUWFNG	[VUWFNG]	V UWF NG
VUWRNG	[VUWRNG]	V UWR NG
VUWXA	[VUWXA]	V UWXA
VUWXNG	[VUWXNG]	V UWX NG
VUWJC	[VUWJC]	V UWJ C
X	[X]	X 
XA	[XA]	X A
XANG	[XANG]	X A NG
XANH	[XANH]	X A NH
XAO	[XAO]	X AO
XAY	[XAY]	X AY
XE	[XE]	X E
XEM	[XEM]	X E M
XEN	[XEN]	X E N
XEO	[XEO]	X EO
XI	[XI]	X I
XIA	[XIA]	X IA
XIN	[XIN]	X I N
XINH	[XINH]	X I NH
XIEEM	[XIEEM]	X IEE M
XIEEU	[XIEEU]	X IEEU
XIEESC	[XIEESC]	X IEES C
XIEEST	[XIEEST]	X IEES T
XOA	[XOA]	X OA
XOAN	[XOAN]	X OA N
XOANG	[XOANG]	X OA NG
XOAY	[XOAY]	X OAY
XOE	[XOE]	X OE
XOEN	[XOEN]	X OE N
XOI	[XOI]	X OI
XOM	[XOM]	X O M
XON	[XON]	X O N
XONG	[XONG]	X O NG
XOAFI	[XOAFI]	X OAFI
XOAFN	[XOAFN]	X OAF N
XOAFNG	[XOAFNG]	X OAF NG
XOAS	[XOAS]	X OAS
XOASY	[XOASY]	X OASY
XOEF	[XOEF]	X OEF
XOEFN	[XOEFN]	X OEF N
XOEST	[XOEST]	X OES T
XOAWN	[XOAWN]	X OAW N
XOAJC	[XOAJC]	X OAJ C
XOARNG	[XOARNG]	X OAR NG
XOAWSN	[XOAWSN]	X OAWS N
XOEJT	[XOEJT]	X OEJ T
XU	[XU]	X U
XUA	[XUA]	X UA
XUI	[XUI]	X UI
XUM	[XUM]	X U M
XUNG	[XUNG]	X U NG
XUYEEN	[XUYEEN]	X UYEE N
XUYEESN	[XUYEESN]	X UYEES N
XUAAN	[XUAAN]	X UAA N
XUEE	[XUEE]	X UEE
XUOOI	[XUOOI]	X UOOI
XUAAST	[XUAAST]	X UAAS T
XUAARN	[XUAARN]	X UAAR N
XUEER	[XUEER]	X UEER
XUOOSNG	[XUOOSNG]	X UOOS NG
XUOOFNG	[XUOOFNG]	X UOOF NG
XY	[XY]	X Y
XAF	[XAF]	X AF
XAFI	[XAFI]	X AFI
XAFM	[XAFM]	X AF M
XAFNG	[XAFNG]	X AF NG
XAFO	[XAFO]	X AFO
XAS	[XAS]	X AS
XASC	[XASC]	X AS C
XASCH	[XASCH]	X AS CH
XASM	[XASM]	X AS M
XASN	[XASN]	X AS N
XASO	[XASO]	X ASO
XAST	[XAST]	X AS T
XAAM	[XAAM]	X AA M
XAAU	[XAAU]	X AAU
XAAY	[XAAY]	X AAY
XAX	[XAX]	X AX
XEF	[XEF]	X EF
XEFO	[XEFO]	X EFO
XES	[XES]	X ES
XEST	[XEST]	X ES T
XEE	[XEE]	X EE
XEENH	[XEENH]	X EE NH
XIF	[XIF]	X IF
XIFU	[XIFU]	X IFU
XIS	[XIS]	X IS
XISCH	[XISCH]	X IS CH
XISNH	[XISNH]	X IS NH
XIST	[XIST]	X IS T
XISU	[XISU]	X ISU
XOFA	[XOFA]	X OFA
XOFNG	[XOFNG]	X OF NG
XOS	[XOS]	X OS
XOSA	[XOSA]	X OSA
XOSC	[XOSC]	X OS C
XOSM	[XOSM]	X OS M
XOST	[XOST]	X OS T
XOO	[XOO]	X OO
XOOI	[XOOI]	X OOI
XOOM	[XOOM]	X OO M
XOON	[XOON]	X OO N
XOONG	[XOONG]	X OO NG
XOXA	[XOXA]	X OXA
XUF	[XUF]	X UF
XUFM	[XUFM]	X UF M
XUSC	[XUSC]	X US C
XUSM	[XUSM]	X US M
XUSNG	[XUSNG]	X US NG
XAWM	[XAWM]	X AW M
XAWNG	[XAWNG]	X AW NG
XOW	[XOW]	X OW
XOWI	[XOWI]	X OWI
XUWA	[XUWA]	X UWA
XUWNG	[XUWNG]	X UW NG
XUWOWNG	[XUWOWNG]	X UWOW NG
XUWOWSNG	[XUWOWSNG]	X UWOWS NG
XUWOWRNG	[XUWOWRNG]	X UWOWR NG
XAJ	[XAJ]	X AJ
XAJC	[XAJC]	X AJ C
XAJCH	[XAJCH]	X AJ CH
XAJO	[XAJO]	X AJO
XAJP	[XAJP]	X AJ P
XAR	[XAR]	X AR
XARM	[XARM]	X AR M
XARO	[XARO]	X ARO
XARY	[XARY]	X ARY
XAASU	[XAASU]	X AASU
XAARM	[XAARM]	X AAR M
XAARY	[XAARY]	X AARY
XAWSC	[XAWSC]	X AWS C
XAWSN	[XAWSN]	X AWS N
XAWST	[XAWST]	X AWS T
XAWXNG	[XAWXNG]	X AWX NG
XEJO	[XEJO]	X EJO
XEJP	[XEJP]	X EJ P
XER	[XER]	X ER
XERNG	[XERNG]	X ER NG
XEES	[XEES]	X EES
XEESCH	[XEESCH]	X EES CH
XEESP	[XEESP]	X EES P
XEEFNH	[XEEFNH]	X EEF NH
XEER	[XEER]	X EER
XEEJCH	[XEEJCH]	X EEJ CH
XIR	[XIR]	X IR
XIRA	[XIRA]	X IRA
XIRN	[XIRN]	X IR N
XIRNH	[XIRNH]	X IR NH
XIRU	[XIRU]	X IRU
XIJ	[XIJ]	X IJ
XIJT	[XIJT]	X IJ T
XOJC	[XOJC]	X OJ C
XOJP	[XOJP]	X OJ P
XOR	[XOR]	X OR
XOOSC	[XOOSC]	X OOS C
XOOSI	[XOOSI]	X OOSI
XOOSN	[XOOSN]	X OOS N
XOOSNG	[XOOSNG]	X OOS NG
XOOSP	[XOOSP]	X OOS P
XOOFNG	[XOOFNG]	X OOF NG
XOOR	[XOOR]	X OOR
XOORI	[XOORI]	X OORI
XOORM	[XOORM]	X OOR M
XOORNG	[XOORNG]	X OOR NG
XOOJC	[XOOJC]	X OOJ C
XOOJN	[XOOJN]	X OOJ N
XOWSI	[XOWSI]	X OWSI
XOWST	[XOWST]	X OWS T
XOWR	[XOWR]	X OWR
XOWRI	[XOWRI]	X OWRI
XOWJT	[XOWJT]	X OWJ T
XUJ	[XUJ]	X UJ
XUJC	[XUJC]	X UJ C
XUJI	[XUJI]	X UJI
XUWS	[XUWS]	X UWS
XUWSNG	[XUWSNG]	X UWS NG
XUWR	[XUWR]	X UWR
XUWRA	[XUWRA]	X UWRA
XUWRNG	[XUWRNG]	X UWR NG
Y	[Y]	Y
YEEN	[YEEN]	YEE N
YEENG	[YEENG]	YEE NG
YEEU	[YEEU]	YEEU
YEESM	[YEESM]	YEES M
YEESN	[YEESN]	YEES N
YEESU	[YEESU]	YEESU
YEERM	[YEERM]	YEER M
AF	[AF]	AF
AFO	[AFO]	AFO
AS	[AS]	AS
ASC	[ASC]	AS C
ASCH	[ASCH]	AS CH
ASI	[ASI]	ASI
ASM	[ASM]	AS M
ASN	[ASN]	AS N
ASNH	[ASNH]	AS NH
ASO	[ASO]	ASO
ASP	[ASP]	AS P
AST	[AST]	AS T
ASY	[ASY]	ASY
AAM	[AAM]	AA M
AAN	[AAN]	AA N
AAU	[AAU]	AAU
AAY	[AAY]	AAY
AX	[AX]	AX
EF	[EF]	EF
EFO	[EFO]	EFO
ES	[ES]	ES
ESN	[ESN]	ES N
ESO	[ESO]	ESO
ESP	[ESP]	ES P
EE	[EE]	EE
EEM	[EEM]	EE M
IF	[IF]	IF
IS	[IS]	IS
ISCH	[ISCH]	IS CH
IST	[IST]	IS T
OFA	[OFA]	OFA
OFNG	[OFNG]	OF NG
OSC	[OSC]	OS C
OSE	[OSE]	OSE
OSI	[OSI]	OSI
OSNG	[OSNG]	OS NG
OO	[OO]	OO
OOI	[OOI]	OOI
OOM	[OOM]	OO M
OON	[OON]	OO N
OONG	[OONG]	OO NG
UF	[UF]	UF
UFA	[UFA]	UFA
UFN	[UFN]	UF N
US	[US]	US
USA	[USA]	USA
USM	[USM]	US M
USNG	[USNG]	US NG
USP	[USP]	US P
UST	[UST]	US T
USY	[USY]	USY
YS	[YS]	YS
AWM	[AWM]	AW M
AWN	[AWN]	AW N
DDA	[DDA]	DD A
DDAI	[DDAI]	DD AI
DDAM	[DDAM]	DD A M
DDAN	[DDAN]	DD A N
DDANG	[DDANG]	DD A NG
DDANH	[DDANH]	DD A NH
DDAO	[DDAO]	DD AO
DDAU	[DDAU]	DD AU
DDAY	[DDAY]	DD AY
DDE	[DDE]	DD E
DDEM	[DDEM]	DD E M
DDEN	[DDEN]	DD E N
DDEO	[DDEO]	DD EO
DDI	[DDI]	DD I
DDIA	[DDIA]	DD IA
DDINH	[DDINH]	DD I NH
DDIEEN	[DDIEEN]	DD IEE N
DDIEEU	[DDIEEU]	DD IEEU
DDIEESC	[DDIEESC]	DD IEES C
DDIEESM	[DDIEESM]	DD IEES M
DDIEESU	[DDIEESU]	DD IEESU
DDIEEFM	[DDIEEFM]	DD IEEF M
DDIEEFN	[DDIEEFN]	DD IEEF N
DDIEEFU	[DDIEEFU]	DD IEEFU
DDIEERM	[DDIEERM]	DD IEER M
DDIEERN	[DDIEERN]	DD IEER N
DDIEERU	[DDIEERU]	DD IEERU
DDIEEJM	[DDIEEJM]	DD IEEJ M
DDIEEJN	[DDIEEJN]	DD IEEJ N
DDIEEJP	[DDIEEJP]	DD IEEJ P
DDIEEJU	[DDIEEJU]	DD IEEJU
DDO	[DDO]	DD O
DDOAN	[DDOAN]	DD OA N
DDOM	[DDOM]	DD O M
DDONG	[DDONG]	DD O NG
DDOAFI	[DDOAFI]	DD OAFI
DDOAFN	[DDOAFN]	DD OAF N
DDOAFNG	[DDOAFNG]	DD OAF NG
DDOASN	[DDOASN]	DD OAS N
DDOAJN	[DDOAJN]	DD OAJ N
DDOAJT	[DDOAJT]	DD OAJ T
DDOARNG	[DDOARNG]	DD OAR NG
DDU	[DDU]	DD U
DDUA	[DDUA]	DD UA
DDUI	[DDUI]	DD UI
DDUN	[DDUN]	DD U N
DDUNG	[DDUNG]	DD U NG
DDUOOI	[DDUOOI]	DD UOOI
DDUOOSC	[DDUOOSC]	DD UOOS C
DDUOOSI	[DDUOOSI]	DD UOOSI
DDUOORI	[DDUOORI]	DD UOORI
DDUOOJT	[DDUOOJT]	DD UOOJ T
DDAF	[DDAF]	DD AF
DDAFI	[DDAFI]	DD AFI
DDAFM	[DDAFM]	DD AF M
DDAFN	[DDAFN]	DD AF N
DDAFNG	[DDAFNG]	DD AF NG
DDAFNH	[DDAFNH]	DD AF NH
DDAFO	[DDAFO]	DD AFO
DDAS	[DDAS]	DD AS
DDASC	[DDASC]	DD AS C
DDASI	[DDASI]	DD ASI
DDASM	[DDASM]	DD AS M
DDASNG	[DDASNG]	DD AS NG
DDASNH	[DDASNH]	DD AS NH
DDASO	[DDASO]	DD ASO
DDASP	[DDASP]	DD AS P
DDASY	[DDASY]	DD ASY
DDAAM	[DDAAM]	DD AA M
DDAAU	[DDAAU]	DD AAU
DDAAY	[DDAAY]	DD AAY
DDAX	[DDAX]	DD AX
DDAXI	[DDAXI]	DD AXI
DDAXNG	[DDAXNG]	DD AX NG
DDEF	[DDEF]	DD EF
DDEFN	[DDEFN]	DD EF N
DDEFO	[DDEFO]	DD EFO
DDESC	[DDESC]	DD ES C
DDESO	[DDESO]	DD ESO
DDEE	[DDEE]	DD EE
DDEEM	[DDEEM]	DD EE M
DDEENH	[DDEENH]	DD EE NH
DDEEU	[DDEEU]	DD EEU
DDIFA	[DDIFA]	DD IFA
DDIFNH	[DDIFNH]	DD IF NH
DDIFU	[DDIFU]	DD IFU
DDISCH	[DDISCH]	DD IS CH
DDISNH	[DDISNH]	DD IS NH
DDIST	[DDIST]	DD IS T
DDOF	[DDOF]	DD OF
DDOFI	[DDOFI]	DD OFI
DDOFM	[DDOFM]	DD OF M
DDOFN	[DDOFN]	DD OF N
DDOFNG	[DDOFNG]	DD OF NG
DDOS	[DDOS]	DD OS
DDOSA	[DDOSA]	DD OSA
DDOSI	[DDOSI]	DD OSI
DDOSM	[DDOSM]	DD OS M
DDOSN	[DDOSN]	DD OS N
DDOSNG	[DDOSNG]	DD OS NG
DDOO	[DDOO]	DD OO
DDOOI	[DDOOI]	DD OOI
DDOON	[DDOON]	DD OO N
DDOONG	[DDOONG]	DD OO NG
DDUFA	[DDUFA]	DD UFA
DDUFI	[DDUFI]	DD UFI
DDUFM	[DDUFM]	DD UF M
DDUFNG	[DDUFNG]	DD UF NG
DDUS	[DDUS]	DD US
DDUSC	[DDUSC]	DD US C
DDUSM	[DDUSM]	DD US M
DDUSNG	[DDUSNG]	DD US NG
DDUSP	[DDUSP]	DD US P
DDUST	[DDUST]	DD US T
DDAWNG	[DDAWNG]	DD AW NG
DDIX	[DDIX]	DD IX
DDIXA	[DDIXA]	DD IXA
DDUXA	[DDUXA]	DD UXA
DDUXNG	[DDUXNG]	DD UX NG
DDOW	[DDOW]	DD OW
DDOWM	[DDOWM]	DD OW M
DDOWN	[DDOWN]	DD OW N
DDUWA	[DDUWA]	DD UWA
DDUWOWNG	[DDUWOWNG]	DD UWOW NG
DDUWOWSC	[DDUWOWSC]	DD UWOWS C
DDUWOWFNG	[DDUWOWFNG]	DD UWOWF NG
DDUWOWJC	[DDUWOWJC]	DD UWOWJ C
DDAJC	[DDAJC]	DD AJ C
DDAJCH	[DDAJCH]	DD AJ CH
DDAJI	[DDAJI]	DD AJI
DDAJM	[DDAJM]	DD AJ M
DDAJN	[DDAJN]	DD AJ N
DDAJO	[DDAJO]	DD AJO
DDAJP	[DDAJP]	DD AJ P
DDAJT	[DDAJT]	DD AJ T
DDAR	[DDAR]	DD AR
DDARM	[DDARM]	DD AR M
DDARN	[DDARN]	DD AR N
DDARNG	[DDARNG]	DD AR NG
DDARO	[DDARO]	DD ARO
DDAASM	[DDAASM]	DD AAS M
DDAAST	[DDAAST]	DD AAS T
DDAASU	[DDAASU]	DD AASU
DDAASY	[DDAASY]	DD AASY
DDAAFM	[DDAAFM]	DD AAF M
DDAAFU	[DDAAFU]	DD AAFU
DDAAFY	[DDAAFY]	DD AAFY
DDAARU	[DDAARU]	DD AARU
DDAARY	[DDAARY]	DD AARY
DDAAXM	[DDAAXM]	DD AAX M
DDAAXY	[DDAAXY]	DD AAXY
DDAAJM	[DDAAJM]	DD AAJ M
DDAAJN	[DDAAJN]	DD AAJ N
DDAAJP	[DDAAJP]	DD AAJ P
DDAAJT	[DDAAJT]	DD AAJ T
DDAAJU	[DDAAJU]	DD AAJU
DDAAJY	[DDAAJY]	DD AAJY
DDAWSC	[DDAWSC]	DD AWS C
DDAWSM	[DDAWSM]	DD AWS M
DDAWSN	[DDAWSN]	DD AWS N
DDAWSNG	[DDAWSNG]	DD AWS NG
DDAWSP	[DDAWSP]	DD AWS P
DDAWST	[DDAWST]	DD AWS T
DDAWFM	[DDAWFM]	DD AWF M
DDAWFNG	[DDAWFNG]	DD AWF NG
DDAWRNG	[DDAWRNG]	DD AWR NG
DDAWJC	[DDAWJC]	DD AWJ C
DDAWJN	[DDAWJN]	DD AWJ N
DDAWJNG	[DDAWJNG]	DD AWJ NG
DDAWJT	[DDAWJT]	DD AWJ T
DDEJP	[DDEJP]	DD EJ P
DDER	[DDER]	DD ER
DDEX	[DDEX]	DD EX
DDEXO	[DDEXO]	DD EXO
DDEES	[DDEES]	DD EES
DDEESM	[DDEESM]	DD EES M
DDEESN	[DDEESN]	DD EES N
DDEEF	[DDEEF]	DD EEF
DDEEFM	[DDEEFM]	DD EEF M
DDEEFN	[DDEEFN]	DD EEF N
DDEEFNH	[DDEEFNH]	DD EEF NH
DDEEFU	[DDEEFU]	DD EEFU
DDEER	[DDEER]	DD EER
DDEERNH	[DDEERNH]	DD EER NH
DDEERU	[DDEERU]	DD EERU
DDEEXNH	[DDEEXNH]	DD EEX NH
DDEEJ	[DDEEJ]	DD EEJ
DDEEJM	[DDEEJM]	DD EEJ M
DDIRNH	[DDIRNH]	DD IR NH
DDIJA	[DDIJA]	DD IJA
DDIJCH	[DDIJCH]	DD IJ CH
DDIJNH	[DDIJNH]	DD IJ NH
DDIJU	[DDIJU]	DD IJU
DDOJ	[DDOJ]	DD OJ
DDOJC	[DDOJC]	DD OJ C
DDOJNG	[DDOJNG]	DD OJ NG
DDOR	[DDOR]	DD OR
DDOOS	[DDOOS]	DD OOS
DDOOSC	[DDOOSC]	DD OOS C
DDOOSI	[DDOOSI]	DD OOSI
DDOOSM	[DDOOSM]	DD OOS M
DDOOSN	[DDOOSN]	DD OOS N
DDOOSNG	[DDOOSNG]	DD OOS NG
DDOOST	[DDOOST]	DD OOS T
DDOOF	[DDOOF]	DD OOF
DDOOFI	[DDOOFI]	DD OOFI
DDOOFN	[DDOOFN]	DD OOF N
DDOOFNG	[DDOOFNG]	DD OOF NG
DDOOR	[DDOOR]	DD OOR
DDOORI	[DDOORI]	DD OORI
DDOORNG	[DDOORNG]	DD OOR NG
DDOOX	[DDOOX]	DD OOX
DDOOXI	[DDOOXI]	DD OOXI
DDOOJ	[DDOOJ]	DD OOJ
DDOOJC	[DDOOJC]	DD OOJ C
DDOOJI	[DDOOJI]	DD OOJI
DDOOJN	[DDOOJN]	DD OOJ N
DDOOJNG	[DDOOJNG]	DD OOJ NG
DDOOJP	[DDOOJP]	DD OOJ P
DDOOJT	[DDOOJT]	DD OOJ T
DDOWSI	[DDOWSI]	DD OWSI
DDOWSN	[DDOWSN]	DD OWS N
DDOWF	[DDOWF]	DD OWF
DDOWFI	[DDOWFI]	DD OWFI
DDOWFM	[DDOWFM]	DD OWF M
DDOWFN	[DDOWFN]	DD OWF N
DDOWX	[DDOWX]	DD OWX
DDOWJI	[DDOWJI]	DD OWJI
DDOWJP	[DDOWJP]	DD OWJ P
DDOWJT	[DDOWJT]	DD OWJ T
DDUJC	[DDUJC]	DD UJ C
DDUJN	[DDUJN]	DD UJ N
DDUJNG	[DDUJNG]	DD UJ NG
DDUR	[DDUR]	DD UR
DDUWSA	[DDUWSA]	DD UWSA
DDUWSC	[DDUWSC]	DD UWS C
DDUWSNG	[DDUWSNG]	DD UWS NG
DDUWST	[DDUWST]	DD UWS T
DDUWFNG	[DDUWFNG]	DD UWF NG
DDUWJNG	[DDUWJNG]	DD UWJ NG
IX	[IX]	IX
OW	[OW]	OW
OWI	[OWI]	OWI
OWN	[OWN]	OW N
UW	[UW]	UW
UWA	[UWA]	UWA
UWNG	[UWNG]	UW NG
UWU	[UWU]	UWU
UWOWM	[UWOWM]	UWOW M
UWOWNG	[UWOWNG]	UWOW NG
UWOWSC	[UWOWSC]	UWOWS C
UWOWSP	[UWOWSP]	UWOWS P
UWOWST	[UWOWST]	UWOWS T
AJ	[AJ]	AJ
AJCH	[AJCH]	AJ CH
AJT	[AJT]	AJ T
AR	[AR]	AR
ARM	[ARM]	AR M
ARNH	[ARNH]	AR NH
ARO	[ARO]	ARO
AASM	[AASM]	AAS M
AASN	[AASN]	AAS N
AASP	[AASP]	AAS P
AASU	[AASU]	AASU
AASY	[AASY]	AASY
AAFM	[AAFM]	AAF M
AAFU	[AAFU]	AAFU
AARM	[AARM]	AAR M
AARN	[AARN]	AAR N
AARU	[AARU]	AARU
AAJM	[AAJM]	AAJ M
AWSP	[AWSP]	AWS P
AWST	[AWST]	AWS T
AWFNG	[AWFNG]	AWF NG
AWXM	[AWXM]	AWX M
AWJC	[AWJC]	AWJ C
ERN	[ERN]	ER N
EES	[EES]	EES
EESCH	[EESCH]	EES CH
EEFNH	[EEFNH]	EEF NH
EEJCH	[EEJCH]	EEJ CH
EEJN	[EEJN]	EEJ N
IRA	[IRA]	IRA
IRM	[IRM]	IR M
IRN	[IRN]	IR N
IRU	[IRU]	IRU
IJCH	[IJCH]	IJ CH
OJC	[OJC]	OJ C
OJE	[OJE]	OJE
ORI	[ORI]	ORI
ORN	[ORN]	OR N
ORNG	[ORNG]	OR NG
OOSC	[OOSC]	OOS C
OOSM	[OOSM]	OOS M
OOSNG	[OOSNG]	OOS NG
OOSP	[OOSP]	OOS P
OOF	[OOF]	OOF
OOFN	[OOFN]	OOF N
OOFNG	[OOFNG]	OOF NG
OOR	[OOR]	OOR
OORI	[OORI]	OORI
OORN	[OORN]	OOR N
OORNG	[OORNG]	OOR NG
OOJC	[OOJC]	OOJ C
OOJN	[OOJN]	OOJ N
OOJP	[OOJP]	OOJ P
OWS	[OWS]	OWS
OWSI	[OWSI]	OWSI
OWSN	[OWSN]	OWS N
OWST	[OWST]	OWS T
OWF	[OWF]	OWF
OWR	[OWR]	OWR
OWJ	[OWJ]	OWJ
UJ	[UJ]	UJ
UJC	[UJC]	UJ C
UR	[UR]	UR
URA	[URA]	URA
URI	[URI]	URI
URN	[URN]	UR N
URNG	[URNG]	UR NG
URY	[URY]	URY
UWS	[UWS]	UWS
UWSA	[UWSA]	UWSA
UWSC	[UWSC]	UWS C
UWSNG	[UWSNG]	UWS NG
UWF	[UWF]	UWF
UWRNG	[UWRNG]	UWR NG
YR	[YR]	YR
